Country_Name,Country_Code,Year,Population,Gold,Silver,Bronze,Total_Medals
Austria,AUT,1960,7047539.0,1,2,3,6
Canada,CAN,1960,17909356.0,2,1,1,4
Finland,FIN,1960,4429634.0,2,3,3,8
France,FRA,1960,46649927.0,1,0,2,3
Italy,ITA,1960,50199700.0,0,0,1,1
Norway,NOR,1960,3581239.0,3,3,0,6
Poland,POL,1960,29637450.0,0,1,1,2
Sweden,SWE,1960,7484656.0,3,2,2,7
United States,USA,1960,180671000.0,3,4,3,10
Austria,AUT,1964,7223801.0,4,5,3,12
Canada,CAN,1964,19325000.0,1,1,1,3
Finland,FIN,1964,4548543.0,3,4,3,10
France,FRA,1964,48733997.0,3,4,0,7
United Kingdom,GBR,1964,54000000.0,1,0,0,1
Italy,ITA,1964,51675350.0,0,1,3,4
Norway,NOR,1964,3694339.0,3,6,6,15
"Korea, Dem. People's Rep.",PRK,1964,12787523.0,0,1,0,1
Sweden,SWE,1964,7661354.0,3,3,1,7
United States,USA,1964,191889000.0,1,2,4,7
Austria,AUT,1968,7415403.0,3,4,4,11
Canada,CAN,1968,20744000.0,1,1,1,3
Finland,FIN,1968,4626469.0,1,2,2,5
France,FRA,1968,50817020.0,4,3,2,9
Italy,ITA,1968,53235750.0,4,0,0,4
Norway,NOR,1968,3816486.0,6,6,2,14
Romania,ROU,1968,19799831.0,0,0,1,1
Sweden,SWE,1968,7912273.0,3,2,3,8
United States,USA,1968,200706000.0,1,5,1,7
Austria,AUT,1972,7544201.0,1,2,2,5
Canada,CAN,1972,22218463.0,0,1,0,1
Spain,ESP,1972,34604469.0,1,0,0,1
Finland,FIN,1972,4639657.0,0,4,1,5
France,FRA,1972,52637888.0,0,1,2,3
Italy,ITA,1972,54381345.0,2,2,1,5
Japan,JPN,1972,107188000.0,1,1,1,3
Norway,NOR,1972,3933004.0,2,5,5,12
Poland,POL,1972,33055650.0,1,0,0,1
Sweden,SWE,1972,8122300.0,1,1,2,4
United States,USA,1972,209896000.0,3,2,3,8
Austria,AUT,1976,7565525.0,2,2,2,6
Canada,CAN,1976,23449808.0,1,1,1,3
Finland,FIN,1976,4725664.0,2,4,1,7
France,FRA,1976,53966558.0,0,0,1,1
United Kingdom,GBR,1976,56211968.0,1,0,0,1
Italy,ITA,1976,55718260.0,1,2,1,4
Liechtenstein,LIE,1976,23416.0,0,0,2,2
Norway,NOR,1976,4026152.0,3,3,1,7
Sweden,SWE,1976,8222286.0,0,0,2,2
United States,USA,1976,218035000.0,3,3,4,10
Austria,AUT,1980,7549433.0,3,2,2,7
Canada,CAN,1980,24515667.0,0,1,1,2
Finland,FIN,1980,4779535.0,1,5,3,9
France,FRA,1980,55052582.0,0,0,1,1
United Kingdom,GBR,1980,56314216.0,1,0,0,1
Hungary,HUN,1980,10711122.0,0,1,0,1
Italy,ITA,1980,56433883.0,0,2,0,2
Japan,JPN,1980,116807000.0,0,1,0,1
Liechtenstein,LIE,1980,25003.0,2,2,0,4
Norway,NOR,1980,4085620.0,1,3,6,10
Sweden,SWE,1980,8310531.0,3,0,1,4
United States,USA,1980,227225000.0,6,4,2,12
Austria,AUT,1984,7561434.0,0,0,1,1
Canada,CAN,1984,25607053.0,2,1,1,4
Finland,FIN,1984,4881803.0,4,3,6,13
France,FRA,1984,56275701.0,0,1,2,3
United Kingdom,GBR,1984,56422072.0,1,0,0,1
Italy,ITA,1984,56576718.0,2,0,0,2
Japan,JPN,1984,120083000.0,0,1,0,1
Liechtenstein,LIE,1984,26420.0,0,0,2,2
Norway,NOR,1984,4140099.0,3,2,4,9
Sweden,SWE,1984,8336605.0,4,2,2,8
United States,USA,1984,235825000.0,4,4,0,8
Austria,AUT,1988,7585317.0,3,5,2,10
Canada,CAN,1988,26791747.0,0,2,3,5
Finland,FIN,1988,4946481.0,4,1,2,7
France,FRA,1988,57472651.0,1,0,1,2
Italy,ITA,1988,56629288.0,2,1,2,5
Japan,JPN,1988,122578000.0,0,0,1,1
Liechtenstein,LIE,1988,27944.0,0,0,1,1
Norway,NOR,1988,4209488.0,0,3,2,5
Sweden,SWE,1988,8436489.0,4,0,2,6
United States,USA,1988,244499000.0,2,1,3,6
Austria,AUT,1992,7840709.0,6,7,8,21
Canada,CAN,1992,28371264.0,2,3,2,7
China,CHN,1992,1164970000.0,0,3,0,3
Spain,ESP,1992,39157685.0,0,0,1,1
Finland,FIN,1992,5041992.0,3,1,3,7
France,FRA,1992,58849943.0,3,5,1,9
Italy,ITA,1992,56797087.0,4,6,4,14
Japan,JPN,1992,124425000.0,1,2,4,7
"Korea, Rep.",KOR,1992,43747962.0,2,1,1,4
Luxembourg,LUX,1992,392175.0,0,2,0,2
Norway,NOR,1992,4286401.0,9,6,5,20
New Zealand,NZL,1992,3531700.0,0,1,0,1
"Korea, Dem. People's Rep.",PRK,1992,21439991.0,0,0,1,1
Sweden,SWE,1992,8668067.0,1,0,3,4
United States,USA,1992,256514000.0,5,4,2,11
Australia,AUS,1994,17805468.0,0,0,1,1
Austria,AUT,1994,7936118.0,2,3,4,9
Belarus,BLR,1994,10226955.0,0,2,0,2
Canada,CAN,1994,29000663.0,3,6,4,13
China,CHN,1994,1191835000.0,0,1,2,3
Finland,FIN,1994,5088333.0,0,1,5,6
France,FRA,1994,59327585.0,0,1,4,5
United Kingdom,GBR,1994,57865745.0,0,0,2,2
Italy,ITA,1994,56843400.0,7,5,8,20
Japan,JPN,1994,125178000.0,1,2,2,5
Kazakhstan,KAZ,1994,16145766.0,1,2,0,3
"Korea, Rep.",KOR,1994,44641540.0,4,1,1,6
Norway,NOR,1994,4336613.0,10,11,5,26
Russian Federation,RUS,1994,148407912.0,11,8,4,23
Sweden,SWE,1994,8780745.0,2,1,0,3
Ukraine,UKR,1994,51921400.0,1,0,1,2
United States,USA,1994,263126000.0,6,5,2,13
Uzbekistan,UZB,1994,22377000.0,1,0,0,1
Australia,AUS,1998,18607584.0,0,0,1,1
Austria,AUT,1998,7976789.0,3,5,9,17
Belgium,BEL,1998,10203008.0,0,0,1,1
Belarus,BLR,1998,10071963.0,0,0,2,2
Canada,CAN,1998,30155173.0,6,5,4,15
China,CHN,1998,1241935000.0,0,6,2,8
Czechia,CZE,1998,10294373.0,1,1,1,3
Finland,FIN,1998,5153498.0,2,4,6,12
France,FRA,1998,60192790.0,2,1,5,8
United Kingdom,GBR,1998,58487141.0,0,0,1,1
Italy,ITA,1998,56906744.0,2,6,2,10
Japan,JPN,1998,126400000.0,5,1,4,10
Kazakhstan,KAZ,1998,15071640.0,0,0,2,2
"Korea, Rep.",KOR,1998,46286503.0,3,1,2,6
Norway,NOR,1998,4431464.0,10,10,5,25
Russian Federation,RUS,1998,147670784.0,9,6,3,18
Sweden,SWE,1998,8850974.0,0,2,1,3
Ukraine,UKR,1998,50144500.0,0,1,0,1
United States,USA,1998,275854000.0,6,3,4,13
Australia,AUS,2002,19495210.0,2,0,0,2
Austria,AUT,2002,8081957.0,3,3,10,16
Belarus,BLR,2002,9865548.0,0,0,1,1
Canada,CAN,2002,31360079.0,7,3,7,17
China,CHN,2002,1280400000.0,2,2,4,8
Czechia,CZE,2002,10196916.0,1,2,0,3
Estonia,EST,2002,1379350.0,1,1,1,3
Finland,FIN,2002,5200598.0,4,2,1,7
France,FRA,2002,61816234.0,4,5,2,11
United Kingdom,GBR,2002,59370479.0,1,0,0,1
Italy,ITA,2002,57059007.0,4,4,5,13
Japan,JPN,2002,127445000.0,0,1,1,2
"Korea, Rep.",KOR,2002,47644736.0,2,2,0,4
Norway,NOR,2002,4538159.0,13,5,7,25
Poland,POL,2002,38230364.0,0,1,1,2
Russian Federation,RUS,2002,145306497.0,5,4,4,13
Sweden,SWE,2002,8924958.0,0,2,5,7
United States,USA,2002,287625193.0,8,12,11,31
Australia,AUS,2006,20450966.0,1,0,1,2
Austria,AUT,2006,8268641.0,9,7,7,23
Belarus,BLR,2006,9604924.0,0,1,0,1
Canada,CAN,2006,32571174.0,6,9,6,21
China,CHN,2006,1311020000.0,2,4,5,11
Czechia,CZE,2006,10238905.0,1,2,1,4
Estonia,EST,2006,1346810.0,3,0,0,3
Finland,FIN,2006,5266268.0,0,6,3,9
France,FRA,2006,63628261.0,3,2,4,9
Italy,ITA,2006,58143979.0,5,0,6,11
Japan,JPN,2006,127854000.0,1,0,0,1
"Korea, Rep.",KOR,2006,48438292.0,6,3,2,11
Norway,NOR,2006,4660677.0,2,8,9,19
Poland,POL,2006,38141267.0,0,1,1,2
Russian Federation,RUS,2006,143049637.0,8,6,8,22
Slovak Republic,SVK,2006,5373054.0,0,1,0,1
Sweden,SWE,2006,9080505.0,7,2,5,14
Ukraine,UKR,2006,46787786.0,0,0,2,2
United States,USA,2006,298379912.0,9,9,7,25
Australia,AUS,2010,22031750.0,2,1,0,3
Austria,AUT,2010,8363404.0,4,6,6,16
Belarus,BLR,2010,9483836.0,1,1,1,3
Canada,CAN,2010,34004889.0,14,7,5,26
China,CHN,2010,1337705000.0,5,2,4,11
Czechia,CZE,2010,10474410.0,2,0,4,6
Estonia,EST,2010,1331475.0,0,1,0,1
Finland,FIN,2010,5363352.0,0,1,4,5
France,FRA,2010,65030575.0,2,3,6,11
United Kingdom,GBR,2010,62766365.0,1,0,0,1
Italy,ITA,2010,59277417.0,1,1,3,5
Japan,JPN,2010,128070000.0,0,3,2,5
Kazakhstan,KAZ,2010,16321872.0,0,1,0,1
"Korea, Rep.",KOR,2010,49554112.0,6,6,2,14
Norway,NOR,2010,4889252.0,9,8,6,23
Poland,POL,2010,38042794.0,1,3,2,6
Russian Federation,RUS,2010,142849468.0,3,5,7,15
Slovak Republic,SVK,2010,5391428.0,1,1,1,3
Sweden,SWE,2010,9378126.0,5,2,4,11
United States,USA,2010,309327143.0,9,15,13,37
Australia,AUS,2014,23475686.0,0,2,1,3
Austria,AUT,2014,8546356.0,4,8,5,17
Belarus,BLR,2014,9448515.0,5,0,1,6
Canada,CAN,2014,35437435.0,10,10,5,25
China,CHN,2014,1371860000.0,3,4,2,9
Czechia,CZE,2014,10525347.0,2,4,3,9
Finland,FIN,2014,5461512.0,1,3,1,5
France,FRA,2014,66312067.0,4,4,7,15
United Kingdom,GBR,2014,64602298.0,1,1,3,5
Italy,ITA,2014,60789140.0,0,2,6,8
Japan,JPN,2014,127276000.0,1,4,3,8
Kazakhstan,KAZ,2014,17288285.0,0,0,1,1
"Korea, Rep.",KOR,2014,50746659.0,3,3,2,8
Norway,NOR,2014,5137232.0,11,6,9,26
Poland,POL,2014,38011735.0,4,1,1,6
Russian Federation,RUS,2014,143819667.0,10,10,9,29
Slovak Republic,SVK,2014,5418649.0,1,0,0,1
Sweden,SWE,2014,9696110.0,2,7,6,15
Ukraine,UKR,2014,45272155.0,1,0,1,2
United States,USA,2014,318386329.0,9,9,10,28
Australia,AUS,2018,24966643.0,0,2,1,3
Austria,AUT,2018,8840521.0,5,3,6,14
Belgium,BEL,2018,11427054.0,0,1,0,1
Belarus,BLR,2018,9438785.0,2,1,0,3
Canada,CAN,2018,37065084.0,11,8,10,29
China,CHN,2018,1402760000.0,1,6,2,9
Czechia,CZE,2018,10629928.0,2,2,3,7
Spain,ESP,2018,46797754.0,0,0,2,2
Finland,FIN,2018,5515525.0,1,1,4,6
France,FRA,2018,67158348.0,5,4,6,15
United Kingdom,GBR,2018,66460344.0,1,0,4,5
Hungary,HUN,2018,9775564.0,1,0,0,1
Italy,ITA,2018,60421760.0,3,2,5,10
Japan,JPN,2018,126811000.0,4,5,4,13
Kazakhstan,KAZ,2018,18276452.0,0,0,1,1
"Korea, Rep.",KOR,2018,51585058.0,5,8,4,17
Liechtenstein,LIE,2018,38181.0,0,0,1,1
Norway,NOR,2018,5311916.0,14,14,11,39
New Zealand,NZL,2018,4900600.0,0,0,2,2
Poland,POL,2018,37974750.0,1,0,1,2
Slovak Republic,SVK,2018,5446771.0,1,2,0,3
Sweden,SWE,2018,10175214.0,7,6,1,14
Ukraine,UKR,2018,44622518.0,1,0,0,1
United States,USA,2018,326838199.0,9,8,6,23
