Country_Name,Country_Code,Year,Population,Gold,Silver,Bronze,Total_Medals,Season
Argentina,ARG,1960,20349744.0,0,1,1,2,Summer
Australia,AUS,1960,10276477.0,8,8,6,22,Summer
Austria,AUT,1960,7047539.0,1,1,0,2,Summer
Austria,AUT,1960,7047539.0,1,2,3,6,Winter
Belgium,BEL,1960,9153489.0,0,2,2,4,Summer
Brazil,BRA,1960,73092515.0,0,0,2,2,Summer
Canada,CAN,1960,17909356.0,0,1,0,1,Summer
Canada,CAN,1960,17909356.0,2,1,1,4,Winter
Spain,ESP,1960,30455000.0,0,0,1,1,Summer
Ethiopia,ETH,1960,21739710.0,1,0,0,1,Summer
Finland,FIN,1960,4429634.0,1,1,3,5,Summer
Finland,FIN,1960,4429634.0,2,3,3,8,Winter
France,FRA,1960,46649927.0,0,2,3,5,Summer
France,FRA,1960,46649927.0,1,0,2,3,Winter
United Kingdom,GBR,1960,52400000.0,2,6,12,20,Summer
Ghana,GHA,1960,6911510.0,0,1,0,1,Summer
Hungary,HUN,1960,9983967.0,6,8,7,21,Summer
India,IND,1960,445954579.0,0,1,0,1,Summer
Iraq,IRQ,1960,7084678.0,0,0,1,1,Summer
Italy,ITA,1960,50199700.0,13,10,13,36,Summer
Italy,ITA,1960,50199700.0,0,0,1,1,Winter
Japan,JPN,1960,93216000.0,4,7,7,18,Summer
Morocco,MAR,1960,11769774.0,0,1,0,1,Summer
Mexico,MEX,1960,36268055.0,0,0,1,1,Summer
Norway,NOR,1960,3581239.0,1,0,0,1,Summer
Norway,NOR,1960,3581239.0,3,3,0,6,Winter
New Zealand,NZL,1960,2371800.0,2,0,1,3,Summer
Pakistan,PAK,1960,45954226.0,1,0,1,2,Summer
Poland,POL,1960,29637450.0,4,6,11,21,Summer
Poland,POL,1960,29637450.0,0,1,1,2,Winter
Romania,ROU,1960,18406905.0,3,1,6,10,Summer
Singapore,SGP,1960,1646400.0,0,1,0,1,Summer
Sweden,SWE,1960,7484656.0,1,2,3,6,Summer
Sweden,SWE,1960,7484656.0,3,2,2,7,Winter
Turkiye,TUR,1960,27510980.0,7,2,0,9,Summer
United States,USA,1960,180671000.0,34,21,16,71,Summer
United States,USA,1960,180671000.0,3,4,3,10,Winter
"Venezuela, RB",VEN,1960,8156937.0,0,0,1,1,Summer
Argentina,ARG,1964,21708487.0,0,1,0,1,Summer
Australia,AUS,1964,11167000.0,6,2,10,18,Summer
Austria,AUT,1964,7223801.0,4,5,3,12,Winter
Belgium,BEL,1964,9378113.0,2,0,1,3,Summer
Brazil,BRA,1964,82262794.0,0,0,1,1,Summer
Canada,CAN,1964,19325000.0,1,2,1,4,Summer
Canada,CAN,1964,19325000.0,1,1,1,3,Winter
Cuba,CUB,1964,7902286.0,0,1,0,1,Summer
Ethiopia,ETH,1964,24073696.0,1,0,0,1,Summer
Finland,FIN,1964,4548543.0,3,0,2,5,Summer
Finland,FIN,1964,4548543.0,3,4,3,10,Winter
France,FRA,1964,48733997.0,1,8,6,15,Summer
France,FRA,1964,48733997.0,3,4,0,7,Winter
United Kingdom,GBR,1964,54000000.0,4,12,2,18,Summer
United Kingdom,GBR,1964,54000000.0,1,0,0,1,Winter
Ghana,GHA,1964,7640196.0,0,0,1,1,Summer
Hungary,HUN,1964,10119835.0,10,7,5,22,Summer
India,IND,1964,489059309.0,1,0,0,1,Summer
Ireland,IRL,1964,2866550.0,0,0,1,1,Summer
Italy,ITA,1964,51675350.0,10,10,7,27,Summer
Italy,ITA,1964,51675350.0,0,1,3,4,Winter
Japan,JPN,1964,96903000.0,16,5,8,29,Summer
Kenya,KEN,1964,9047387.0,0,0,1,1,Summer
"Korea, Rep.",KOR,1964,27984155.0,0,2,1,3,Summer
Mexico,MEX,1964,41333878.0,0,0,1,1,Summer
Norway,NOR,1964,3694339.0,3,6,6,15,Winter
New Zealand,NZL,1964,2585400.0,3,0,2,5,Summer
Pakistan,PAK,1964,50552592.0,0,1,0,1,Summer
Poland,POL,1964,31139450.0,7,6,10,23,Summer
"Korea, Dem. People's Rep.",PRK,1964,12787523.0,0,1,0,1,Winter
Romania,ROU,1964,18919126.0,2,4,6,12,Summer
Sweden,SWE,1964,7661354.0,2,2,4,8,Summer
Sweden,SWE,1964,7661354.0,3,3,1,7,Winter
Trinidad and Tobago,TTO,1964,913399.0,0,1,2,3,Summer
Tunisia,TUN,1964,4389417.0,0,1,1,2,Summer
Turkiye,TUR,1964,30612821.0,2,3,1,6,Summer
United States,USA,1964,191889000.0,36,26,28,90,Summer
United States,USA,1964,191889000.0,1,2,4,7,Winter
Argentina,ARG,1968,23112971.0,0,0,2,2,Summer
Australia,AUS,1968,12009000.0,5,7,5,17,Summer
Austria,AUT,1968,7415403.0,0,2,2,4,Summer
Austria,AUT,1968,7415403.0,3,4,4,11,Winter
Belgium,BEL,1968,9618756.0,0,1,1,2,Summer
Brazil,BRA,1968,91659246.0,0,1,2,3,Summer
Canada,CAN,1968,20744000.0,1,3,1,5,Summer
Canada,CAN,1968,20744000.0,1,1,1,3,Winter
Cameroon,CMR,1968,6127193.0,0,1,0,1,Summer
Cuba,CUB,1968,8550286.0,0,4,0,4,Summer
Ethiopia,ETH,1968,26778653.0,1,1,0,2,Summer
Finland,FIN,1968,4626469.0,1,2,1,4,Summer
Finland,FIN,1968,4626469.0,1,2,2,5,Winter
France,FRA,1968,50817020.0,7,3,5,15,Summer
France,FRA,1968,50817020.0,4,3,2,9,Winter
United Kingdom,GBR,1968,55211700.0,5,5,3,13,Summer
Hungary,HUN,1968,10255815.0,10,10,12,32,Summer
India,IND,1968,533431909.0,0,0,1,1,Summer
Italy,ITA,1968,53235750.0,3,4,9,16,Summer
Italy,ITA,1968,53235750.0,4,0,0,4,Winter
Jamaica,JAM,1968,1812209.0,0,1,0,1,Summer
Japan,JPN,1968,101011000.0,11,7,7,25,Summer
Kenya,KEN,1968,10613877.0,3,4,2,9,Summer
"Korea, Rep.",KOR,1968,30838302.0,0,1,1,2,Summer
Mexico,MEX,1968,47170337.0,3,3,3,9,Summer
Norway,NOR,1968,3816486.0,1,1,0,2,Summer
Norway,NOR,1968,3816486.0,6,6,2,14,Winter
New Zealand,NZL,1968,2748100.0,1,0,2,3,Summer
Pakistan,PAK,1968,56124743.0,1,0,0,1,Summer
Poland,POL,1968,32294655.0,5,2,11,18,Summer
Romania,ROU,1968,19799831.0,4,6,5,15,Summer
Romania,ROU,1968,19799831.0,0,0,1,1,Winter
Sweden,SWE,1968,7912273.0,2,1,1,4,Summer
Sweden,SWE,1968,7912273.0,3,2,3,8,Winter
Tunisia,TUN,1968,4785003.0,1,0,1,2,Summer
Turkiye,TUR,1968,33884075.0,2,0,0,2,Summer
Uganda,UGA,1968,9696370.0,0,1,1,2,Summer
United States,USA,1968,200706000.0,45,28,34,107,Summer
United States,USA,1968,200706000.0,1,5,1,7,Winter
"Venezuela, RB",VEN,1968,10672654.0,1,0,0,1,Summer
Argentina,ARG,1972,24612794.0,0,1,0,1,Summer
Australia,AUS,1972,13177000.0,8,7,2,17,Summer
Austria,AUT,1972,7544201.0,0,1,2,3,Summer
Austria,AUT,1972,7544201.0,1,2,2,5,Winter
Belgium,BEL,1972,9711115.0,0,2,0,2,Summer
Brazil,BRA,1972,101194394.0,0,0,2,2,Summer
Canada,CAN,1972,22218463.0,0,2,3,5,Summer
Canada,CAN,1972,22218463.0,0,1,0,1,Winter
Colombia,COL,1972,21898055.0,0,1,2,3,Summer
Cuba,CUB,1972,9169289.0,3,1,4,8,Summer
Spain,ESP,1972,34604469.0,0,0,1,1,Summer
Spain,ESP,1972,34604469.0,1,0,0,1,Winter
Ethiopia,ETH,1972,29891328.0,0,0,2,2,Summer
Finland,FIN,1972,4639657.0,3,1,4,8,Summer
Finland,FIN,1972,4639657.0,0,4,1,5,Winter
France,FRA,1972,52637888.0,2,4,7,13,Summer
France,FRA,1972,52637888.0,0,1,2,3,Winter
United Kingdom,GBR,1972,56086065.0,4,5,9,18,Summer
Ghana,GHA,1972,9365952.0,0,0,1,1,Summer
Hungary,HUN,1972,10398489.0,6,13,16,35,Summer
India,IND,1972,582837973.0,0,0,1,1,Summer
Italy,ITA,1972,54381345.0,5,3,10,18,Summer
Italy,ITA,1972,54381345.0,2,2,1,5,Winter
Jamaica,JAM,1972,1915299.0,0,0,1,1,Summer
Japan,JPN,1972,107188000.0,13,8,8,29,Summer
Japan,JPN,1972,107188000.0,1,1,1,3,Winter
Kenya,KEN,1972,12322903.0,2,3,4,9,Summer
"Korea, Rep.",KOR,1972,33505406.0,0,1,0,1,Summer
Lebanon,LBN,1972,2505965.0,0,1,0,1,Summer
Mexico,MEX,1972,53543436.0,0,1,0,1,Summer
Norway,NOR,1972,3933004.0,2,1,1,4,Summer
Norway,NOR,1972,3933004.0,2,5,5,12,Winter
New Zealand,NZL,1972,2903900.0,1,1,1,3,Summer
Pakistan,PAK,1972,62509565.0,0,1,0,1,Summer
Poland,POL,1972,33055650.0,7,5,9,21,Summer
Poland,POL,1972,33055650.0,1,0,0,1,Winter
"Korea, Dem. People's Rep.",PRK,1972,15768363.0,1,1,3,5,Summer
Romania,ROU,1972,20657957.0,3,6,7,16,Summer
Sweden,SWE,1972,8122300.0,4,6,6,16,Summer
Sweden,SWE,1972,8122300.0,1,1,2,4,Winter
Tunisia,TUN,1972,5320148.0,0,1,0,1,Summer
Turkiye,TUR,1972,37188035.0,0,1,0,1,Summer
Uganda,UGA,1972,10885563.0,1,1,0,2,Summer
United States,USA,1972,209896000.0,33,31,30,94,Summer
United States,USA,1972,209896000.0,3,2,3,8,Winter
Australia,AUS,1976,14033000.0,0,1,4,5,Summer
Austria,AUT,1976,7565525.0,0,0,1,1,Summer
Austria,AUT,1976,7565525.0,2,2,2,6,Winter
Belgium,BEL,1976,9818227.0,0,3,3,6,Summer
Brazil,BRA,1976,111286504.0,0,0,2,2,Summer
Canada,CAN,1976,23449808.0,0,5,6,11,Summer
Canada,CAN,1976,23449808.0,1,1,1,3,Winter
Cuba,CUB,1976,9600862.0,6,4,3,13,Summer
Spain,ESP,1976,36137812.0,0,2,0,2,Summer
Finland,FIN,1976,4725664.0,4,2,0,6,Summer
Finland,FIN,1976,4725664.0,2,4,1,7,Winter
France,FRA,1976,53966558.0,2,3,4,9,Summer
France,FRA,1976,53966558.0,0,0,1,1,Winter
United Kingdom,GBR,1976,56211968.0,3,5,5,13,Summer
United Kingdom,GBR,1976,56211968.0,1,0,0,1,Winter
Hungary,HUN,1976,10598677.0,4,5,13,22,Summer
Italy,ITA,1976,55718260.0,2,7,4,13,Summer
Italy,ITA,1976,55718260.0,1,2,1,4,Winter
Jamaica,JAM,1976,2029486.0,1,1,0,2,Summer
Japan,JPN,1976,112775000.0,9,6,10,25,Summer
"Korea, Rep.",KOR,1976,35848523.0,1,1,4,6,Summer
Liechtenstein,LIE,1976,23416.0,0,0,2,2,Winter
Mexico,MEX,1976,60452543.0,1,0,1,2,Summer
Norway,NOR,1976,4026152.0,1,1,0,2,Summer
Norway,NOR,1976,4026152.0,3,3,1,7,Winter
New Zealand,NZL,1976,3110500.0,2,1,1,4,Summer
Pakistan,PAK,1976,70230923.0,0,0,1,1,Summer
Poland,POL,1976,34356300.0,7,6,13,26,Summer
"Korea, Dem. People's Rep.",PRK,1976,16987170.0,1,1,0,2,Summer
Romania,ROU,1976,21551634.0,4,9,14,27,Summer
Sweden,SWE,1976,8222286.0,4,1,0,5,Summer
Sweden,SWE,1976,8222286.0,0,0,2,2,Winter
Thailand,THA,1976,41882128.0,0,0,1,1,Summer
Trinidad and Tobago,TTO,1976,1067696.0,1,0,0,1,Summer
United States,USA,1976,218035000.0,34,35,25,94,Summer
United States,USA,1976,218035000.0,3,3,4,10,Winter
"Venezuela, RB",VEN,1976,13566112.0,0,1,0,1,Summer
Australia,AUS,1980,14692000.0,2,2,5,9,Summer
Austria,AUT,1980,7549433.0,1,2,1,4,Summer
Austria,AUT,1980,7549433.0,3,2,2,7,Winter
Belgium,BEL,1980,9859242.0,1,0,0,1,Summer
Brazil,BRA,1980,122288383.0,2,0,2,4,Summer
Canada,CAN,1980,24515667.0,0,1,1,2,Winter
Cuba,CUB,1980,9809107.0,8,7,5,20,Summer
Spain,ESP,1980,37491165.0,1,3,2,6,Summer
Ethiopia,ETH,1980,34945469.0,2,0,2,4,Summer
Finland,FIN,1980,4779535.0,3,1,4,8,Summer
Finland,FIN,1980,4779535.0,1,5,3,9,Winter
France,FRA,1980,55052582.0,6,5,3,14,Summer
France,FRA,1980,55052582.0,0,0,1,1,Winter
United Kingdom,GBR,1980,56314216.0,5,7,9,21,Summer
United Kingdom,GBR,1980,56314216.0,1,0,0,1,Winter
Guyana,GUY,1980,778176.0,0,0,1,1,Summer
Hungary,HUN,1980,10711122.0,7,10,15,32,Summer
Hungary,HUN,1980,10711122.0,0,1,0,1,Winter
India,IND,1980,696828385.0,1,0,0,1,Summer
Ireland,IRL,1980,3412800.0,0,1,1,2,Summer
Italy,ITA,1980,56433883.0,8,3,4,15,Summer
Italy,ITA,1980,56433883.0,0,2,0,2,Winter
Jamaica,JAM,1980,2135546.0,0,0,3,3,Summer
Japan,JPN,1980,116807000.0,0,1,0,1,Winter
Lebanon,LBN,1980,2963702.0,0,0,1,1,Summer
Liechtenstein,LIE,1980,25003.0,2,2,0,4,Winter
Mexico,MEX,1980,67705186.0,0,1,3,4,Summer
Norway,NOR,1980,4085620.0,1,3,6,10,Winter
Poland,POL,1980,35574150.0,3,14,15,32,Summer
"Korea, Dem. People's Rep.",PRK,1980,17973650.0,0,3,2,5,Summer
Romania,ROU,1980,22207282.0,6,6,13,25,Summer
Sweden,SWE,1980,8310531.0,3,3,6,12,Summer
Sweden,SWE,1980,8310531.0,3,0,1,4,Winter
Uganda,UGA,1980,13284026.0,0,1,0,1,Summer
United States,USA,1980,227225000.0,6,4,2,12,Winter
"Venezuela, RB",VEN,1980,15210443.0,0,1,0,1,Summer
Australia,AUS,1984,15579391.0,4,8,12,24,Summer
Austria,AUT,1984,7561434.0,1,1,1,3,Summer
Austria,AUT,1984,7561434.0,0,0,1,1,Winter
Belgium,BEL,1984,9855372.0,1,1,2,4,Summer
Brazil,BRA,1984,133888775.0,1,5,2,8,Summer
Canada,CAN,1984,25607053.0,10,18,16,44,Summer
Canada,CAN,1984,25607053.0,2,1,1,4,Winter
China,CHN,1984,1036825000.0,15,8,9,32,Summer
Cote d'Ivoire,CIV,1984,9621405.0,0,1,0,1,Summer
Cameroon,CMR,1984,9508570.0,0,0,1,1,Summer
Colombia,COL,1984,28689032.0,0,1,0,1,Summer
Dominican Republic,DOM,1984,6282104.0,0,0,1,1,Summer
"Egypt, Arab Rep.",EGY,1984,48676443.0,0,1,0,1,Summer
Spain,ESP,1984,38330364.0,1,2,2,5,Summer
Finland,FIN,1984,4881803.0,4,2,6,12,Summer
Finland,FIN,1984,4881803.0,4,3,6,13,Winter
France,FRA,1984,56275701.0,5,7,16,28,Summer
France,FRA,1984,56275701.0,0,1,2,3,Winter
United Kingdom,GBR,1984,56422072.0,5,11,21,37,Summer
United Kingdom,GBR,1984,56422072.0,1,0,0,1,Winter
Ireland,IRL,1984,3532423.0,0,1,0,1,Summer
Iceland,ISL,1984,239511.0,0,0,1,1,Summer
Italy,ITA,1984,56576718.0,14,6,12,32,Summer
Italy,ITA,1984,56576718.0,2,0,0,2,Winter
Jamaica,JAM,1984,2264095.0,0,1,2,3,Summer
Japan,JPN,1984,120083000.0,10,8,14,32,Summer
Japan,JPN,1984,120083000.0,0,1,0,1,Winter
Kenya,KEN,1984,18753176.0,1,0,2,3,Summer
"Korea, Rep.",KOR,1984,40405956.0,6,6,7,19,Summer
Liechtenstein,LIE,1984,26420.0,0,0,2,2,Winter
Morocco,MAR,1984,21817271.0,2,0,0,2,Summer
Mexico,MEX,1984,73489654.0,2,3,1,6,Summer
Norway,NOR,1984,4140099.0,0,1,2,3,Summer
Norway,NOR,1984,4140099.0,3,2,4,9,Winter
New Zealand,NZL,1984,3227100.0,8,1,2,11,Summer
Pakistan,PAK,1984,94003867.0,1,0,0,1,Summer
Peru,PER,1984,19285646.0,0,1,0,1,Summer
Romania,ROU,1984,22640547.0,20,16,17,53,Summer
Sweden,SWE,1984,8336605.0,2,11,6,19,Summer
Sweden,SWE,1984,8336605.0,4,2,2,8,Winter
Syrian Arab Republic,SYR,1984,10183138.0,0,1,0,1,Summer
Thailand,THA,1984,49636724.0,0,1,0,1,Summer
Turkiye,TUR,1984,48106764.0,0,0,3,3,Summer
United States,USA,1984,235825000.0,83,61,30,174,Summer
United States,USA,1984,235825000.0,4,4,0,8,Winter
"Venezuela, RB",VEN,1984,16953234.0,0,0,3,3,Summer
Argentina,ARG,1988,31690792.0,0,1,1,2,Summer
Australia,AUS,1988,16532164.0,3,6,5,14,Summer
Austria,AUT,1988,7585317.0,1,0,0,1,Summer
Austria,AUT,1988,7585317.0,3,5,2,10,Winter
Belgium,BEL,1988,9901664.0,0,0,2,2,Summer
Brazil,BRA,1988,145253973.0,1,2,3,6,Summer
Canada,CAN,1988,26791747.0,3,2,5,10,Summer
Canada,CAN,1988,26791747.0,0,2,3,5,Winter
Channel Islands,CHI,1988,137765.0,0,1,0,1,Summer
China,CHN,1988,1101630000.0,5,11,12,28,Summer
Colombia,COL,1988,31256727.0,0,0,1,1,Summer
Djibouti,DJI,1988,482337.0,0,0,1,1,Summer
Spain,ESP,1988,38766939.0,1,1,2,4,Summer
Finland,FIN,1988,4946481.0,1,1,2,4,Summer
Finland,FIN,1988,4946481.0,4,1,2,7,Winter
France,FRA,1988,57472651.0,6,4,6,16,Summer
France,FRA,1988,57472651.0,1,0,1,2,Winter
United Kingdom,GBR,1988,56928327.0,5,10,9,24,Summer
Hungary,HUN,1988,10596487.0,11,6,6,23,Summer
Italy,ITA,1988,56629288.0,6,4,4,14,Summer
Italy,ITA,1988,56629288.0,2,1,2,5,Winter
Jamaica,JAM,1988,2354805.0,0,2,0,2,Summer
Japan,JPN,1988,122578000.0,4,3,7,14,Summer
Japan,JPN,1988,122578000.0,0,0,1,1,Winter
Kenya,KEN,1988,21626122.0,5,2,2,9,Summer
"Korea, Rep.",KOR,1988,42031247.0,12,10,11,33,Summer
Liechtenstein,LIE,1988,27944.0,0,0,1,1,Winter
Morocco,MAR,1988,23720590.0,1,0,2,3,Summer
Mexico,MEX,1988,78892015.0,0,0,2,2,Summer
Norway,NOR,1988,4209488.0,2,3,0,5,Summer
Norway,NOR,1988,4209488.0,0,3,2,5,Winter
New Zealand,NZL,1988,3283400.0,3,2,8,13,Summer
Pakistan,PAK,1988,107967838.0,0,0,1,1,Summer
Peru,PER,1988,21143799.0,0,1,0,1,Summer
Poland,POL,1988,37824487.0,2,5,9,16,Summer
Romania,ROU,1988,23057662.0,7,11,6,24,Summer
Senegal,SEN,1988,7113636.0,0,1,0,1,Summer
Suriname,SUR,1988,402139.0,1,0,0,1,Summer
Sweden,SWE,1988,8436489.0,0,4,7,11,Summer
Sweden,SWE,1988,8436489.0,4,0,2,6,Winter
Thailand,THA,1988,53410965.0,0,0,1,1,Summer
Turkiye,TUR,1988,52275890.0,1,1,0,2,Summer
United States,USA,1988,244499000.0,36,31,27,94,Summer
United States,USA,1988,244499000.0,2,1,3,6,Winter
Argentina,ARG,1992,33568285.0,0,0,1,1,Summer
Australia,AUS,1992,17478635.0,7,9,11,27,Summer
Austria,AUT,1992,7840709.0,0,2,0,2,Summer
Austria,AUT,1992,7840709.0,6,7,8,21,Winter
Belgium,BEL,1992,10045158.0,0,1,2,3,Summer
Brazil,BRA,1992,155900790.0,2,1,0,3,Summer
Canada,CAN,1992,28371264.0,7,4,7,18,Summer
Canada,CAN,1992,28371264.0,2,3,2,7,Winter
China,CHN,1992,1164970000.0,16,22,16,54,Summer
China,CHN,1992,1164970000.0,0,3,0,3,Winter
Colombia,COL,1992,33939039.0,0,0,1,1,Summer
Cuba,CUB,1992,10783748.0,14,6,11,31,Summer
Spain,ESP,1992,39157685.0,13,7,2,22,Summer
Spain,ESP,1992,39157685.0,0,0,1,1,Winter
Estonia,EST,1992,1533091.0,1,0,1,2,Summer
Ethiopia,ETH,1992,52011554.0,1,0,2,3,Summer
Finland,FIN,1992,5041992.0,1,2,2,5,Summer
Finland,FIN,1992,5041992.0,3,1,3,7,Winter
France,FRA,1992,58849943.0,8,5,16,29,Summer
France,FRA,1992,58849943.0,3,5,1,9,Winter
United Kingdom,GBR,1992,57580402.0,5,3,12,20,Summer
Ghana,GHA,1992,16241548.0,0,0,1,1,Summer
Hungary,HUN,1992,10369341.0,11,12,7,30,Summer
Ireland,IRL,1992,3558430.0,1,1,0,2,Summer
Israel,ISR,1992,5123000.0,0,1,1,2,Summer
Italy,ITA,1992,56797087.0,6,5,8,19,Summer
Italy,ITA,1992,56797087.0,4,6,4,14,Winter
Jamaica,JAM,1992,2434574.0,0,3,1,4,Summer
Japan,JPN,1992,124425000.0,3,8,11,22,Summer
Japan,JPN,1992,124425000.0,1,2,4,7,Winter
Kenya,KEN,1992,24655723.0,2,4,2,8,Summer
"Korea, Rep.",KOR,1992,43747962.0,12,5,12,29,Summer
"Korea, Rep.",KOR,1992,43747962.0,2,1,1,4,Winter
Lithuania,LTU,1992,3700114.0,1,0,1,2,Summer
Luxembourg,LUX,1992,392175.0,0,2,0,2,Winter
Morocco,MAR,1992,25400676.0,1,1,1,3,Summer
Mexico,MEX,1992,84993164.0,0,1,0,1,Summer
Namibia,NAM,1992,1461687.0,0,2,0,2,Summer
Norway,NOR,1992,4286401.0,2,4,1,7,Summer
Norway,NOR,1992,4286401.0,9,6,5,20,Winter
New Zealand,NZL,1992,3531700.0,1,4,5,10,Summer
New Zealand,NZL,1992,3531700.0,0,1,0,1,Winter
Pakistan,PAK,1992,122375179.0,0,0,1,1,Summer
Peru,PER,1992,23047248.0,0,1,0,1,Summer
Poland,POL,1992,38363667.0,3,6,10,19,Summer
"Korea, Dem. People's Rep.",PRK,1992,21439991.0,4,0,5,9,Summer
"Korea, Dem. People's Rep.",PRK,1992,21439991.0,0,0,1,1,Winter
Qatar,QAT,1992,471293.0,0,0,1,1,Summer
Romania,ROU,1992,22794284.0,4,6,8,18,Summer
Suriname,SUR,1992,419521.0,0,0,1,1,Summer
Sweden,SWE,1992,8668067.0,1,7,4,12,Summer
Sweden,SWE,1992,8668067.0,1,0,3,4,Winter
Thailand,THA,1992,56939020.0,0,0,1,1,Summer
Turkiye,TUR,1992,56302037.0,2,2,2,6,Summer
United States,USA,1992,256514000.0,37,34,37,108,Summer
United States,USA,1992,256514000.0,5,4,2,11,Winter
Australia,AUS,1994,17805468.0,0,0,1,1,Winter
Austria,AUT,1994,7936118.0,2,3,4,9,Winter
Belarus,BLR,1994,10226955.0,0,2,0,2,Winter
Canada,CAN,1994,29000663.0,3,6,4,13,Winter
China,CHN,1994,1191835000.0,0,1,2,3,Winter
Finland,FIN,1994,5088333.0,0,1,5,6,Winter
France,FRA,1994,59327585.0,0,1,4,5,Winter
United Kingdom,GBR,1994,57865745.0,0,0,2,2,Winter
Italy,ITA,1994,56843400.0,7,5,8,20,Winter
Japan,JPN,1994,125178000.0,1,2,2,5,Winter
Kazakhstan,KAZ,1994,16145766.0,1,2,0,3,Winter
"Korea, Rep.",KOR,1994,44641540.0,4,1,1,6,Winter
Norway,NOR,1994,4336613.0,10,11,5,26,Winter
Russian Federation,RUS,1994,148407912.0,11,8,4,23,Winter
Sweden,SWE,1994,8780745.0,2,1,0,3,Winter
Ukraine,UKR,1994,51921400.0,1,0,1,2,Winter
United States,USA,1994,263126000.0,6,5,2,13,Winter
Uzbekistan,UZB,1994,22377000.0,1,0,0,1,Winter
Argentina,ARG,1996,35389362.0,0,2,1,3,Summer
Armenia,ARM,1996,3298898.0,1,1,0,2,Summer
Australia,AUS,1996,18224767.0,9,9,23,41,Summer
Austria,AUT,1996,7959017.0,0,1,2,3,Summer
Azerbaijan,AZE,1996,7763000.0,0,1,0,1,Summer
Burundi,BDI,1996,5930507.0,1,0,0,1,Summer
Belgium,BEL,1996,10156637.0,2,2,2,6,Summer
Belarus,BLR,1996,10159569.0,1,6,8,15,Summer
Brazil,BRA,1996,166037122.0,3,3,9,15,Summer
Canada,CAN,1996,29610218.0,3,11,8,22,Summer
China,CHN,1996,1217550000.0,16,22,12,50,Summer
Cuba,CUB,1996,10963031.0,9,8,8,25,Summer
Czechia,CZE,1996,10315241.0,4,3,4,11,Summer
Ecuador,ECU,1996,11775221.0,1,0,0,1,Summer
Spain,ESP,1996,39889852.0,5,6,6,17,Summer
Ethiopia,ETH,1996,59347649.0,2,0,1,3,Summer
Finland,FIN,1996,5124573.0,1,2,1,4,Summer
France,FRA,1996,59756533.0,15,7,15,37,Summer
United Kingdom,GBR,1996,58166950.0,1,8,6,15,Summer
Georgia,GEO,1996,4491699.0,0,0,2,2,Summer
"Hong Kong SAR, China",HKG,1996,6435500.0,1,0,0,1,Summer
Hungary,HUN,1996,10311238.0,7,4,10,21,Summer
India,IND,1996,983281218.0,0,0,1,1,Summer
Ireland,IRL,1996,3637510.0,3,0,1,4,Summer
Israel,ISR,1996,5692000.0,0,0,1,1,Summer
Italy,ITA,1996,56860281.0,13,10,12,35,Summer
Jamaica,JAM,1996,2532894.0,1,3,2,6,Summer
Japan,JPN,1996,125757000.0,3,6,5,14,Summer
Kazakhstan,KAZ,1996,15578227.0,3,4,4,11,Summer
Kenya,KEN,1996,27615736.0,1,4,3,8,Summer
"Korea, Rep.",KOR,1996,45524681.0,7,15,5,27,Summer
Lithuania,LTU,1996,3601613.0,0,0,1,1,Summer
Morocco,MAR,1996,26999093.0,0,0,2,2,Summer
Moldova,MDA,1996,2947293.0,0,1,1,2,Summer
Mexico,MEX,1996,91586555.0,0,0,1,1,Summer
Mozambique,MOZ,1996,16079553.0,0,0,1,1,Summer
Namibia,NAM,1996,1650066.0,0,2,0,2,Summer
Norway,NOR,1996,4381336.0,2,2,3,7,Summer
New Zealand,NZL,1996,3732000.0,3,2,1,6,Summer
Poland,POL,1996,38624370.0,7,5,5,17,Summer
"Korea, Dem. People's Rep.",PRK,1996,22614347.0,2,1,2,5,Summer
Romania,ROU,1996,22619004.0,4,7,9,20,Summer
Russian Federation,RUS,1996,148160129.0,26,21,16,63,Summer
Slovak Republic,SVK,1996,5373361.0,1,1,1,3,Summer
Sweden,SWE,1996,8840998.0,2,4,2,8,Summer
Syrian Arab Republic,SYR,1996,14708879.0,1,0,0,1,Summer
Thailand,THA,1996,60211096.0,1,0,1,2,Summer
Trinidad and Tobago,TTO,1996,1313434.0,0,0,2,2,Summer
Tunisia,TUN,1996,9430550.0,0,0,1,1,Summer
Turkiye,TUR,1996,60293786.0,4,1,1,6,Summer
Uganda,UGA,1996,21249572.0,0,0,1,1,Summer
Ukraine,UKR,1996,51057800.0,9,2,12,23,Summer
United States,USA,1996,269394000.0,44,32,25,101,Summer
Uzbekistan,UZB,1996,23225000.0,0,1,1,2,Summer
Australia,AUS,1998,18607584.0,0,0,1,1,Winter
Austria,AUT,1998,7976789.0,3,5,9,17,Winter
Belgium,BEL,1998,10203008.0,0,0,1,1,Winter
Belarus,BLR,1998,10071963.0,0,0,2,2,Winter
Canada,CAN,1998,30155173.0,6,5,4,15,Winter
China,CHN,1998,1241935000.0,0,6,2,8,Winter
Czechia,CZE,1998,10294373.0,1,1,1,3,Winter
Finland,FIN,1998,5153498.0,2,4,6,12,Winter
France,FRA,1998,60192790.0,2,1,5,8,Winter
United Kingdom,GBR,1998,58487141.0,0,0,1,1,Winter
Italy,ITA,1998,56906744.0,2,6,2,10,Winter
Japan,JPN,1998,126400000.0,5,1,4,10,Winter
Kazakhstan,KAZ,1998,15071640.0,0,0,2,2,Winter
"Korea, Rep.",KOR,1998,46286503.0,3,1,2,6,Winter
Norway,NOR,1998,4431464.0,10,10,5,25,Winter
Russian Federation,RUS,1998,147670784.0,9,6,3,18,Winter
Sweden,SWE,1998,8850974.0,0,2,1,3,Winter
Ukraine,UKR,1998,50144500.0,0,1,0,1,Winter
United States,USA,1998,275854000.0,6,3,4,13,Winter
Argentina,ARG,2000,37070774.0,0,2,2,4,Summer
Armenia,ARM,2000,3168523.0,0,0,1,1,Summer
Australia,AUS,2000,19028802.0,16,25,17,58,Summer
Austria,AUT,2000,8011566.0,2,1,0,3,Summer
Azerbaijan,AZE,2000,8048600.0,2,0,1,3,Summer
Belgium,BEL,2000,10251250.0,0,2,3,5,Summer
Belarus,BLR,2000,9979610.0,3,3,11,17,Summer
Brazil,BRA,2000,175873720.0,0,6,6,12,Summer
Canada,CAN,2000,30685730.0,3,3,8,14,Summer
Channel Islands,CHI,2000,145306.0,0,0,1,1,Summer
China,CHN,2000,1262645000.0,28,16,14,58,Summer
Cameroon,CMR,2000,15091594.0,1,0,0,1,Summer
Colombia,COL,2000,39215135.0,1,0,0,1,Summer
Cuba,CUB,2000,11105791.0,11,11,7,29,Summer
Czechia,CZE,2000,10255063.0,2,3,3,8,Summer
Spain,ESP,2000,40567864.0,3,3,5,11,Summer
Estonia,EST,2000,1396985.0,1,0,2,3,Summer
Ethiopia,ETH,2000,67031867.0,4,1,3,8,Summer
Finland,FIN,2000,5176209.0,2,1,1,4,Summer
France,FRA,2000,60921384.0,13,14,11,38,Summer
United Kingdom,GBR,2000,58892514.0,11,10,7,28,Summer
Georgia,GEO,2000,4077131.0,0,0,6,6,Summer
Hungary,HUN,2000,10210971.0,8,6,3,17,Summer
India,IND,2000,1059633675.0,0,0,1,1,Summer
Ireland,IRL,2000,3805174.0,0,1,0,1,Summer
Iceland,ISL,2000,281205.0,0,0,1,1,Summer
Israel,ISR,2000,6289000.0,0,0,1,1,Summer
Italy,ITA,2000,56942108.0,13,8,13,34,Summer
Jamaica,JAM,2000,2612205.0,0,6,3,9,Summer
Japan,JPN,2000,126843000.0,5,8,5,18,Summer
Kazakhstan,KAZ,2000,14883626.0,3,4,0,7,Summer
Kenya,KEN,2000,30851606.0,2,3,2,7,Summer
Kyrgyz Republic,KGZ,2000,4898400.0,0,0,1,1,Summer
"Korea, Rep.",KOR,2000,47008111.0,8,10,10,28,Summer
Lithuania,LTU,2000,3499536.0,2,0,3,5,Summer
Morocco,MAR,2000,28554415.0,0,1,4,5,Summer
Moldova,MDA,2000,2924668.0,0,1,1,2,Summer
Mexico,MEX,2000,97873442.0,1,2,3,6,Summer
North Macedonia,MKD,2000,2026350.0,0,0,1,1,Summer
Mozambique,MOZ,2000,17768505.0,1,0,0,1,Summer
Norway,NOR,2000,4490967.0,4,3,3,10,Summer
New Zealand,NZL,2000,3857700.0,1,0,3,4,Summer
Poland,POL,2000,38258629.0,6,5,3,14,Summer
"Korea, Dem. People's Rep.",PRK,2000,23367059.0,0,1,3,4,Summer
Qatar,QAT,2000,645937.0,0,0,1,1,Summer
Romania,ROU,2000,22442971.0,11,6,9,26,Summer
Russian Federation,RUS,2000,146596869.0,32,28,29,89,Summer
Slovak Republic,SVK,2000,5388720.0,1,3,1,5,Summer
Sweden,SWE,2000,8872109.0,4,5,3,12,Summer
Thailand,THA,2000,63066603.0,1,0,2,3,Summer
Trinidad and Tobago,TTO,2000,1332203.0,0,1,1,2,Summer
Turkiye,TUR,2000,64113547.0,3,0,2,5,Summer
Ukraine,UKR,2000,49176500.0,3,10,10,23,Summer
United States,USA,2000,282162411.0,37,24,32,93,Summer
Uzbekistan,UZB,2000,24650400.0,1,1,2,4,Summer
Australia,AUS,2002,19495210.0,2,0,0,2,Winter
Austria,AUT,2002,8081957.0,3,3,10,16,Winter
Belarus,BLR,2002,9865548.0,0,0,1,1,Winter
Canada,CAN,2002,31360079.0,7,3,7,17,Winter
China,CHN,2002,1280400000.0,2,2,4,8,Winter
Czechia,CZE,2002,10196916.0,1,2,0,3,Winter
Estonia,EST,2002,1379350.0,1,1,1,3,Winter
Finland,FIN,2002,5200598.0,4,2,1,7,Winter
France,FRA,2002,61816234.0,4,5,2,11,Winter
United Kingdom,GBR,2002,59370479.0,1,0,0,1,Winter
Italy,ITA,2002,57059007.0,4,4,5,13,Winter
Japan,JPN,2002,127445000.0,0,1,1,2,Winter
"Korea, Rep.",KOR,2002,47644736.0,2,2,0,4,Winter
Norway,NOR,2002,4538159.0,13,5,7,25,Winter
Poland,POL,2002,38230364.0,0,1,1,2,Winter
Russian Federation,RUS,2002,145306497.0,5,4,4,13,Winter
Sweden,SWE,2002,8924958.0,0,2,5,7,Winter
United States,USA,2002,287625193.0,8,12,11,31,Winter
Argentina,ARG,2004,38668796.0,2,0,4,6,Summer
Australia,AUS,2004,19932722.0,17,16,17,50,Summer
Austria,AUT,2004,8171966.0,2,4,1,7,Summer
Azerbaijan,AZE,2004,8306500.0,1,0,4,5,Summer
Belgium,BEL,2004,10421137.0,1,0,2,3,Summer
Belarus,BLR,2004,9730146.0,2,5,6,13,Summer
Brazil,BRA,2004,184722043.0,5,2,3,10,Summer
Canada,CAN,2004,31940655.0,3,6,3,12,Summer
Channel Islands,CHI,2004,149538.0,2,0,1,3,Summer
China,CHN,2004,1296075000.0,32,17,14,63,Summer
Cameroon,CMR,2004,16809407.0,1,0,0,1,Summer
Colombia,COL,2004,41648268.0,0,0,2,2,Summer
Cuba,CUB,2004,11225294.0,9,7,11,27,Summer
Czechia,CZE,2004,10197101.0,1,3,5,9,Summer
Dominican Republic,DOM,2004,9043127.0,1,0,0,1,Summer
"Egypt, Arab Rep.",EGY,2004,77522427.0,1,1,3,5,Summer
Eritrea,ERI,2004,2763140.0,0,0,1,1,Summer
Spain,ESP,2004,42921895.0,3,11,6,20,Summer
Estonia,EST,2004,1362550.0,0,1,2,3,Summer
Ethiopia,ETH,2004,75301026.0,2,3,2,7,Summer
Finland,FIN,2004,5228172.0,0,2,0,2,Summer
France,FRA,2004,62716306.0,11,9,13,33,Summer
United Kingdom,GBR,2004,59987905.0,9,9,12,30,Summer
Georgia,GEO,2004,3927340.0,2,2,0,4,Summer
"Hong Kong SAR, China",HKG,2004,6783500.0,0,1,0,1,Summer
Hungary,HUN,2004,10107146.0,8,6,3,17,Summer
India,IND,2004,1136264583.0,0,1,0,1,Summer
Israel,ISR,2004,6809000.0,1,0,1,2,Summer
Italy,ITA,2004,57685327.0,10,11,11,32,Summer
Jamaica,JAM,2004,2664024.0,2,1,2,5,Summer
Japan,JPN,2004,127761000.0,16,9,12,37,Summer
Kazakhstan,KAZ,2004,15012984.0,1,4,3,8,Summer
Kenya,KEN,2004,34791836.0,1,4,2,7,Summer
"Korea, Rep.",KOR,2004,48082519.0,9,12,9,30,Summer
Lithuania,LTU,2004,3377075.0,1,2,0,3,Summer
Morocco,MAR,2004,30033125.0,2,1,0,3,Summer
Mexico,MEX,2004,103945813.0,0,3,1,4,Summer
Norway,NOR,2004,4591910.0,5,0,1,6,Summer
New Zealand,NZL,2004,4087500.0,3,2,0,5,Summer
Poland,POL,2004,38182222.0,3,2,5,10,Summer
"Korea, Dem. People's Rep.",PRK,2004,23948930.0,0,4,1,5,Summer
Romania,ROU,2004,21451748.0,8,5,6,19,Summer
Russian Federation,RUS,2004,144067316.0,28,26,36,90,Summer
Slovak Republic,SVK,2004,5372280.0,2,2,2,6,Summer
Sweden,SWE,2004,8993531.0,4,2,1,7,Summer
Syrian Arab Republic,SYR,2004,18084007.0,0,0,1,1,Summer
Thailand,THA,2004,65311166.0,3,1,4,8,Summer
Trinidad and Tobago,TTO,2004,1361172.0,0,0,1,1,Summer
Turkiye,TUR,2004,67785075.0,3,3,4,10,Summer
Ukraine,UKR,2004,47451626.0,8,5,9,22,Summer
United States,USA,2004,292805298.0,36,39,26,101,Summer
Uzbekistan,UZB,2004,25864350.0,2,1,2,5,Summer
"Venezuela, RB",VEN,2004,26226927.0,0,0,2,2,Summer
Australia,AUS,2006,20450966.0,1,0,1,2,Winter
Austria,AUT,2006,8268641.0,9,7,7,23,Winter
Belarus,BLR,2006,9604924.0,0,1,0,1,Winter
Canada,CAN,2006,32571174.0,6,9,6,21,Winter
China,CHN,2006,1311020000.0,2,4,5,11,Winter
Czechia,CZE,2006,10238905.0,1,2,1,4,Winter
Estonia,EST,2006,1346810.0,3,0,0,3,Winter
Finland,FIN,2006,5266268.0,0,6,3,9,Winter
France,FRA,2006,63628261.0,3,2,4,9,Winter
Italy,ITA,2006,58143979.0,5,0,6,11,Winter
Japan,JPN,2006,127854000.0,1,0,0,1,Winter
"Korea, Rep.",KOR,2006,48438292.0,6,3,2,11,Winter
Norway,NOR,2006,4660677.0,2,8,9,19,Winter
Poland,POL,2006,38141267.0,0,1,1,2,Winter
Russian Federation,RUS,2006,143049637.0,8,6,8,22,Winter
Slovak Republic,SVK,2006,5373054.0,0,1,0,1,Winter
Sweden,SWE,2006,9080505.0,7,2,5,14,Winter
Ukraine,UKR,2006,46787786.0,0,0,2,2,Winter
United States,USA,2006,298379912.0,9,9,7,25,Winter
Afghanistan,AFG,2008,26427199.0,0,0,1,1,Summer
Argentina,ARG,2008,40273769.0,2,0,4,6,Summer
Armenia,ARM,2008,2983421.0,0,1,4,5,Summer
Australia,AUS,2008,21249199.0,14,15,17,46,Summer
Austria,AUT,2008,8321496.0,0,1,2,3,Summer
Azerbaijan,AZE,2008,8763400.0,1,1,4,6,Summer
Belgium,BEL,2008,10709973.0,2,0,0,2,Summer
Belarus,BLR,2008,9527985.0,3,4,7,14,Summer
Brazil,BRA,2008,192672317.0,3,4,10,17,Summer
Canada,CAN,2008,33247118.0,3,9,8,20,Summer
Channel Islands,CHI,2008,154475.0,0,1,0,1,Summer
China,CHN,2008,1324655000.0,48,22,30,100,Summer
Cameroon,CMR,2008,18777081.0,1,0,0,1,Summer
Colombia,COL,2008,43815313.0,0,2,1,3,Summer
Cuba,CUB,2008,11276609.0,3,10,17,30,Summer
Czechia,CZE,2008,10384603.0,3,3,1,7,Summer
Dominican Republic,DOM,2008,9522948.0,1,1,0,2,Summer
Ecuador,ECU,2008,14496797.0,0,1,0,1,Summer
"Egypt, Arab Rep.",EGY,2008,83844783.0,0,0,2,2,Summer
Spain,ESP,2008,45954106.0,5,11,3,19,Summer
Estonia,EST,2008,1337090.0,1,1,0,2,Summer
Ethiopia,ETH,2008,84357105.0,4,2,1,7,Summer
Finland,FIN,2008,5313399.0,1,1,2,4,Summer
France,FRA,2008,64379696.0,7,16,20,43,Summer
United Kingdom,GBR,2008,61806995.0,19,13,19,51,Summer
Georgia,GEO,2008,3848449.0,3,2,2,7,Summer
Hungary,HUN,2008,10038188.0,3,5,2,10,Summer
India,IND,2008,1206734806.0,1,0,2,3,Summer
Ireland,IRL,2008,4489544.0,0,1,2,3,Summer
Iceland,ISL,2008,317414.0,0,1,0,1,Summer
Israel,ISR,2008,7308800.0,0,0,1,1,Summer
Italy,ITA,2008,58826731.0,8,9,10,27,Summer
Jamaica,JAM,2008,2711373.0,5,4,2,11,Summer
Japan,JPN,2008,128063000.0,9,8,8,25,Summer
Kazakhstan,KAZ,2008,15776938.0,2,3,4,9,Summer
Kenya,KEN,2008,39186895.0,6,4,6,16,Summer
Kyrgyz Republic,KGZ,2008,5318700.0,0,1,2,3,Summer
"Korea, Rep.",KOR,2008,49054708.0,13,11,8,32,Summer
Lithuania,LTU,2008,3198231.0,0,3,2,5,Summer
Morocco,MAR,2008,31634992.0,0,1,1,2,Summer
Moldova,MDA,2008,2868833.0,0,0,1,1,Summer
Mexico,MEX,2008,109684489.0,2,0,2,4,Summer
Norway,NOR,2008,4768212.0,3,5,1,9,Summer
New Zealand,NZL,2008,4259800.0,3,2,4,9,Summer
Panama,PAN,2008,3495276.0,1,0,0,1,Summer
Poland,POL,2008,38125759.0,4,5,2,11,Summer
"Korea, Dem. People's Rep.",PRK,2008,24469047.0,2,2,2,6,Summer
Romania,ROU,2008,20537875.0,4,1,4,9,Summer
Russian Federation,RUS,2008,142742366.0,24,13,23,60,Summer
Singapore,SGP,2008,4839396.0,0,1,0,1,Summer
Serbia,SRB,2008,7350222.0,0,1,2,3,Summer
Slovak Republic,SVK,2008,5379233.0,3,3,0,6,Summer
Sweden,SWE,2008,9219637.0,0,4,1,5,Summer
Thailand,THA,2008,67328239.0,2,2,2,6,Summer
Tajikistan,TJK,2008,7324627.0,0,1,1,2,Summer
Trinidad and Tobago,TTO,2008,1392803.0,1,1,0,2,Summer
Tunisia,TUN,2008,10680380.0,1,0,0,1,Summer
Turkiye,TUR,2008,71320726.0,1,1,3,5,Summer
Ukraine,UKR,2008,46258189.0,7,4,11,22,Summer
United States,USA,2008,304093966.0,36,39,37,112,Summer
Uzbekistan,UZB,2008,27302800.0,0,1,3,4,Summer
"Venezuela, RB",VEN,2008,27933833.0,0,0,1,1,Summer
Australia,AUS,2010,22031750.0,2,1,0,3,Winter
Austria,AUT,2010,8363404.0,4,6,6,16,Winter
Belarus,BLR,2010,9483836.0,1,1,1,3,Winter
Canada,CAN,2010,34004889.0,14,7,5,26,Winter
China,CHN,2010,1337705000.0,5,2,4,11,Winter
Czechia,CZE,2010,10474410.0,2,0,4,6,Winter
Estonia,EST,2010,1331475.0,0,1,0,1,Winter
Finland,FIN,2010,5363352.0,0,1,4,5,Winter
France,FRA,2010,65030575.0,2,3,6,11,Winter
United Kingdom,GBR,2010,62766365.0,1,0,0,1,Winter
Italy,ITA,2010,59277417.0,1,1,3,5,Winter
Japan,JPN,2010,128070000.0,0,3,2,5,Winter
Kazakhstan,KAZ,2010,16321872.0,0,1,0,1,Winter
"Korea, Rep.",KOR,2010,49554112.0,6,6,2,14,Winter
Norway,NOR,2010,4889252.0,9,8,6,23,Winter
Poland,POL,2010,38042794.0,1,3,2,6,Winter
Russian Federation,RUS,2010,142849468.0,3,5,7,15,Winter
Slovak Republic,SVK,2010,5391428.0,1,1,1,3,Winter
Sweden,SWE,2010,9378126.0,5,2,4,11,Winter
United States,USA,2010,309327143.0,9,15,13,37,Winter
Afghanistan,AFG,2012,30466479.0,0,0,1,1,Summer
Argentina,ARG,2012,41733271.0,1,1,2,4,Summer
Armenia,ARM,2012,2914421.0,0,1,1,2,Summer
Australia,AUS,2012,22733465.0,8,15,12,35,Summer
Azerbaijan,AZE,2012,9295784.0,2,2,5,9,Summer
Belgium,BEL,2012,11106932.0,0,1,2,3,Summer
Belarus,BLR,2012,9446836.0,2,5,3,10,Summer
Brazil,BRA,2012,199977707.0,3,5,9,17,Summer
Brunei Darussalam,BRN,2012,406634.0,1,0,0,1,Summer
Canada,CAN,2012,34714222.0,2,6,10,18,Summer
China,CHN,2012,1354190000.0,38,31,22,91,Summer
Cameroon,CMR,2012,21032684.0,0,0,1,1,Summer
Colombia,COL,2012,45782417.0,1,3,5,9,Summer
Cuba,CUB,2012,11309290.0,5,3,7,15,Summer
Cyprus,CYP,2012,1156556.0,0,1,0,1,Summer
Czechia,CZE,2012,10510785.0,4,3,4,11,Summer
Dominican Republic,DOM,2012,10030882.0,1,1,0,2,Summer
"Egypt, Arab Rep.",EGY,2012,91240376.0,0,3,1,4,Summer
Spain,ESP,2012,46773055.0,4,10,6,20,Summer
Estonia,EST,2012,1322696.0,0,1,1,2,Summer
Ethiopia,ETH,2012,94451280.0,3,2,3,8,Summer
Finland,FIN,2012,5413971.0,0,2,1,3,Summer
France,FRA,2012,65662240.0,11,11,13,35,Summer
Gabon,GAB,2012,1836705.0,0,1,0,1,Summer
United Kingdom,GBR,2012,63700215.0,29,18,18,65,Summer
Georgia,GEO,2012,3728874.0,1,2,3,6,Summer
"Hong Kong SAR, China",HKG,2012,7150100.0,0,0,1,1,Summer
Hungary,HUN,2012,9920362.0,8,4,6,18,Summer
India,IND,2012,1274487215.0,0,2,4,6,Summer
Ireland,IRL,2012,4599533.0,1,1,4,6,Summer
Italy,ITA,2012,59539717.0,8,9,11,28,Summer
Jamaica,JAM,2012,2759817.0,4,5,3,12,Summer
Japan,JPN,2012,127629000.0,7,14,17,38,Summer
Kazakhstan,KAZ,2012,16792090.0,3,1,7,11,Summer
Kenya,KEN,2012,43725806.0,2,4,7,13,Summer
"Korea, Rep.",KOR,2012,50199853.0,13,9,8,30,Summer
Lithuania,LTU,2012,2987773.0,2,0,3,5,Summer
Morocco,MAR,2012,33352169.0,0,0,1,1,Summer
Mexico,MEX,2012,115755909.0,1,3,4,8,Summer
Montenegro,MNE,2012,620601.0,0,1,0,1,Summer
Norway,NOR,2012,5018573.0,2,1,1,4,Summer
New Zealand,NZL,2012,4408100.0,6,2,5,13,Summer
Poland,POL,2012,38063164.0,3,2,6,11,Summer
"Korea, Dem. People's Rep.",PRK,2012,24887770.0,4,0,3,7,Summer
Qatar,QAT,2012,1905660.0,0,1,1,2,Summer
Romania,ROU,2012,20058035.0,2,4,1,7,Summer
Russian Federation,RUS,2012,143201721.0,19,21,26,66,Summer
Singapore,SGP,2012,5312437.0,0,0,2,2,Summer
Serbia,SRB,2012,7199077.0,1,1,2,4,Summer
Slovak Republic,SVK,2012,5407579.0,0,1,3,4,Summer
Sweden,SWE,2012,9519374.0,1,4,3,8,Summer
Thailand,THA,2012,69157023.0,0,2,2,4,Summer
Tajikistan,TJK,2012,7956382.0,0,0,1,1,Summer
Trinidad and Tobago,TTO,2012,1430377.0,1,1,2,4,Summer
Tunisia,TUN,2012,11174383.0,2,0,1,3,Summer
Turkiye,TUR,2012,75277439.0,1,1,1,3,Summer
Uganda,UGA,2012,34273295.0,1,0,0,1,Summer
Ukraine,UKR,2012,45593342.0,5,4,10,19,Summer
United States,USA,2012,313877662.0,47,27,30,104,Summer
Uzbekistan,UZB,2012,29774500.0,0,0,3,3,Summer
"Venezuela, RB",VEN,2012,29470426.0,1,0,0,1,Summer
Australia,AUS,2014,23475686.0,0,2,1,3,Winter
Austria,AUT,2014,8546356.0,4,8,5,17,Winter
Belarus,BLR,2014,9448515.0,5,0,1,6,Winter
Canada,CAN,2014,35437435.0,10,10,5,25,Winter
China,CHN,2014,1371860000.0,3,4,2,9,Winter
Czechia,CZE,2014,10525347.0,2,4,3,9,Winter
Finland,FIN,2014,5461512.0,1,3,1,5,Winter
France,FRA,2014,66312067.0,4,4,7,15,Winter
United Kingdom,GBR,2014,64602298.0,1,1,3,5,Winter
Italy,ITA,2014,60789140.0,0,2,6,8,Winter
Japan,JPN,2014,127276000.0,1,4,3,8,Winter
Kazakhstan,KAZ,2014,17288285.0,0,0,1,1,Winter
"Korea, Rep.",KOR,2014,50746659.0,3,3,2,8,Winter
Norway,NOR,2014,5137232.0,11,6,9,26,Winter
Poland,POL,2014,38011735.0,4,1,1,6,Winter
Russian Federation,RUS,2014,143819667.0,10,10,9,29,Winter
Slovak Republic,SVK,2014,5418649.0,1,0,0,1,Winter
Sweden,SWE,2014,9696110.0,2,7,6,15,Winter
Ukraine,UKR,2014,45272155.0,1,0,1,2,Winter
United States,USA,2014,318386329.0,9,9,10,28,Winter
Argentina,ARG,2016,43590368.0,3,1,0,4,Summer
Armenia,ARM,2016,2865835.0,1,3,0,4,Summer
Australia,AUS,2016,24190907.0,8,11,10,29,Summer
Austria,AUT,2016,8736668.0,0,0,1,1,Summer
Azerbaijan,AZE,2016,9757812.0,1,7,10,18,Summer
Burundi,BDI,2016,10903327.0,0,1,0,1,Summer
Belgium,BEL,2016,11331422.0,2,2,2,6,Summer
Belarus,BLR,2016,9469379.0,1,4,4,9,Summer
Brazil,BRA,2016,206859578.0,7,6,6,19,Summer
Brunei Darussalam,BRN,2016,425994.0,1,1,0,2,Summer
Canada,CAN,2016,36109487.0,4,3,15,22,Summer
China,CHN,2016,1387790000.0,26,18,26,70,Summer
Cote d'Ivoire,CIV,2016,24213622.0,1,0,1,2,Summer
Colombia,COL,2016,47625955.0,3,2,3,8,Summer
Cuba,CUB,2016,11342012.0,5,2,4,11,Summer
Czechia,CZE,2016,10566332.0,1,2,7,10,Summer
Dominican Republic,DOM,2016,10527592.0,0,0,1,1,Summer
"Egypt, Arab Rep.",EGY,2016,99784030.0,0,0,3,3,Summer
Spain,ESP,2016,46484062.0,7,4,6,17,Summer
Estonia,EST,2016,1315790.0,0,0,1,1,Summer
Ethiopia,ETH,2016,105293228.0,1,2,5,8,Summer
Finland,FIN,2016,5495303.0,0,0,1,1,Summer
France,FRA,2016,66724104.0,10,18,14,42,Summer
United Kingdom,GBR,2016,65611593.0,27,23,17,67,Summer
Georgia,GEO,2016,3727505.0,2,1,4,7,Summer
Hungary,HUN,2016,9814023.0,8,3,4,15,Summer
India,IND,2016,1338636340.0,0,1,1,2,Summer
Ireland,IRL,2016,4755335.0,0,2,0,2,Summer
Israel,ISR,2016,8546000.0,0,0,2,2,Summer
Italy,ITA,2016,60627498.0,8,12,8,28,Summer
Jamaica,JAM,2016,2802695.0,6,3,2,11,Summer
Jordan,JOR,2016,9964656.0,1,0,0,1,Summer
Japan,JPN,2016,127076000.0,12,8,21,41,Summer
Kazakhstan,KAZ,2016,17794055.0,2,5,10,17,Summer
Kenya,KEN,2016,47894670.0,6,6,1,13,Summer
"Korea, Rep.",KOR,2016,51217803.0,9,3,9,21,Summer
Lithuania,LTU,2016,2868231.0,0,1,3,4,Summer
Morocco,MAR,2016,35107264.0,0,0,1,1,Summer
Mexico,MEX,2016,121519221.0,0,3,2,5,Summer
Norway,NOR,2016,5234519.0,0,0,4,4,Summer
New Zealand,NZL,2016,4714100.0,4,9,5,18,Summer
Poland,POL,2016,37970087.0,2,3,6,11,Summer
"Korea, Dem. People's Rep.",PRK,2016,25389611.0,2,3,2,7,Summer
Qatar,QAT,2016,2595166.0,0,1,0,1,Summer
Romania,ROU,2016,19702267.0,1,1,2,4,Summer
Russian Federation,RUS,2016,144342397.0,19,17,20,56,Summer
Singapore,SGP,2016,5607283.0,1,0,0,1,Summer
Serbia,SRB,2016,7058322.0,2,4,2,8,Summer
Slovak Republic,SVK,2016,5430798.0,2,2,0,4,Summer
Sweden,SWE,2016,9923085.0,2,6,3,11,Summer
Thailand,THA,2016,70607037.0,2,2,2,6,Summer
Tajikistan,TJK,2016,8725318.0,1,0,0,1,Summer
Trinidad and Tobago,TTO,2016,1469330.0,0,0,1,1,Summer
Tunisia,TUN,2016,11685667.0,0,0,3,3,Summer
Turkiye,TUR,2016,81019394.0,1,3,4,8,Summer
Ukraine,UKR,2016,45004673.0,2,5,4,11,Summer
United States,USA,2016,323071755.0,46,37,38,121,Summer
Uzbekistan,UZB,2016,31847900.0,4,2,7,13,Summer
"Venezuela, RB",VEN,2016,30741464.0,0,2,1,3,Summer
Australia,AUS,2018,24966643.0,0,2,1,3,Winter
Austria,AUT,2018,8840521.0,5,3,6,14,Winter
Belgium,BEL,2018,11427054.0,0,1,0,1,Winter
Belarus,BLR,2018,9438785.0,2,1,0,3,Winter
Canada,CAN,2018,37065084.0,11,8,10,29,Winter
China,CHN,2018,1402760000.0,1,6,2,9,Winter
Czechia,CZE,2018,10629928.0,2,2,3,7,Winter
Spain,ESP,2018,46797754.0,0,0,2,2,Winter
Finland,FIN,2018,5515525.0,1,1,4,6,Winter
France,FRA,2018,67158348.0,5,4,6,15,Winter
United Kingdom,GBR,2018,66460344.0,1,0,4,5,Winter
Hungary,HUN,2018,9775564.0,1,0,0,1,Winter
Italy,ITA,2018,60421760.0,3,2,5,10,Winter
Japan,JPN,2018,126811000.0,4,5,4,13,Winter
Kazakhstan,KAZ,2018,18276452.0,0,0,1,1,Winter
"Korea, Rep.",KOR,2018,51585058.0,5,8,4,17,Winter
Liechtenstein,LIE,2018,38181.0,0,0,1,1,Winter
Norway,NOR,2018,5311916.0,14,14,11,39,Winter
New Zealand,NZL,2018,4900600.0,0,0,2,2,Winter
Poland,POL,2018,37974750.0,1,0,1,2,Winter
Slovak Republic,SVK,2018,5446771.0,1,2,0,3,Winter
Sweden,SWE,2018,10175214.0,7,6,1,14,Winter
Ukraine,UKR,2018,44622518.0,1,0,0,1,Winter
United States,USA,2018,326838199.0,9,8,6,23,Winter
Argentina,ARG,2020,45376763.0,0,1,2,3,Summer
Armenia,ARM,2020,2805608.0,0,2,2,4,Summer
Australia,AUS,2020,25655289.0,17,7,22,46,Summer
Austria,AUT,2020,8916864.0,1,1,5,7,Summer
Azerbaijan,AZE,2020,10093121.0,0,3,4,7,Summer
Belgium,BEL,2020,11538604.0,3,1,3,7,Summer
Belarus,BLR,2020,9379952.0,1,3,3,7,Summer
Brazil,BRA,2020,213196304.0,7,6,8,21,Summer
Brunei Darussalam,BRN,2020,441725.0,0,1,0,1,Summer
Canada,CAN,2020,38037204.0,7,6,11,24,Summer
China,CHN,2020,1411100000.0,38,32,18,88,Summer
Cote d'Ivoire,CIV,2020,26811790.0,0,0,1,1,Summer
Colombia,COL,2020,50930662.0,0,4,1,5,Summer
Cuba,CUB,2020,11300698.0,7,3,5,15,Summer
Czechia,CZE,2020,10697858.0,4,4,3,11,Summer
Dominican Republic,DOM,2020,10999664.0,0,3,2,5,Summer
Ecuador,ECU,2020,17588595.0,2,1,0,3,Summer
"Egypt, Arab Rep.",EGY,2020,107465134.0,1,1,4,6,Summer
Spain,ESP,2020,47365655.0,3,8,6,17,Summer
Estonia,EST,2020,1329522.0,1,0,1,2,Summer
Ethiopia,ETH,2020,117190911.0,1,1,2,4,Summer
Finland,FIN,2020,5529543.0,0,0,2,2,Summer
France,FRA,2020,67571107.0,10,12,11,33,Summer
United Kingdom,GBR,2020,67081000.0,22,20,22,64,Summer
Georgia,GEO,2020,3722716.0,2,5,1,8,Summer
Ghana,GHA,2020,32180401.0,0,0,1,1,Summer
"Hong Kong SAR, China",HKG,2020,7481000.0,1,2,3,6,Summer
Hungary,HUN,2020,9750149.0,6,7,7,20,Summer
India,IND,2020,1396387127.0,1,2,4,7,Summer
Ireland,IRL,2020,4985382.0,2,0,2,4,Summer
Israel,ISR,2020,9215100.0,2,0,2,4,Summer
Italy,ITA,2020,59438851.0,10,10,20,40,Summer
Jamaica,JAM,2020,2820436.0,4,1,4,9,Summer
Jordan,JOR,2020,10928721.0,0,1,1,2,Summer
Japan,JPN,2020,126261000.0,27,14,17,58,Summer
Kazakhstan,KAZ,2020,18755666.0,0,0,8,8,Summer
Kenya,KEN,2020,51985780.0,4,4,2,10,Summer
Kyrgyz Republic,KGZ,2020,6579900.0,0,2,1,3,Summer
"Korea, Rep.",KOR,2020,51836239.0,6,4,10,20,Summer
Lithuania,LTU,2020,2794885.0,0,1,0,1,Summer
Morocco,MAR,2020,36688772.0,1,0,0,1,Summer
Moldova,MDA,2020,2635130.0,0,0,1,1,Summer
Mexico,MEX,2020,125998302.0,0,0,4,4,Summer
North Macedonia,MKD,2020,2072531.0,0,1,0,1,Summer
Namibia,NAM,2020,2489098.0,0,1,0,1,Summer
Norway,NOR,2020,5379475.0,4,2,2,8,Summer
New Zealand,NZL,2020,5090200.0,7,6,7,20,Summer
Poland,POL,2020,37899070.0,4,5,5,14,Summer
Qatar,QAT,2020,2760385.0,2,0,1,3,Summer
Romania,ROU,2020,19265250.0,1,3,0,4,Summer
San Marino,SMR,2020,34007.0,0,1,2,3,Summer
Serbia,SRB,2020,6899126.0,3,1,5,9,Summer
Slovak Republic,SVK,2020,5458827.0,1,2,1,4,Summer
Sweden,SWE,2020,10353442.0,3,6,0,9,Summer
Syrian Arab Republic,SYR,2020,20772595.0,0,0,1,1,Summer
Thailand,THA,2020,71475664.0,1,0,1,2,Summer
Turkmenistan,TKM,2020,6250438.0,0,1,0,1,Summer
Tunisia,TUN,2020,12161723.0,1,1,0,2,Summer
Turkiye,TUR,2020,84135428.0,2,2,9,13,Summer
Uganda,UGA,2020,44404611.0,2,1,1,4,Summer
Ukraine,UKR,2020,44132049.0,1,6,12,19,Summer
United States,USA,2020,331501080.0,39,41,33,113,Summer
Uzbekistan,UZB,2020,34232050.0,3,0,2,5,Summer
"Venezuela, RB",VEN,2020,28490453.0,1,3,0,4,Summer
