,Country_Name,Country_Code,Season,Year,GDP,Population,GDP_per_capita,Gold,Silver,Bronze,Total_Medals,Gold_Score,Silver_Score,Bronze_Score,Total_Score,Medals_per_GDP
0,Argentina,ARG,Summer,1960,0.0,20349744.0,0.0,0,1,1,2,0,3,3,6,0.0
1,Australia,AUS,Summer,1960,1810510.2489999998,10276477.0,0.17618005168502784,8,8,6,22,24,24,18,66,3.645381186682253e-05
2,Austria,AUT,Summer,1960,935460.4269,7047539.0,0.13273575738992008,1,1,0,2,3,3,0,6,6.413953842904137e-06
3,Austria,AUT,Summer,1960,935460.4269,7047539.0,0.13273575738992008,1,1,0,2,3,3,0,6,6.413953842904137e-06
4,Austria,AUT,Winter,1960,935460.4269,7047539.0,0.13273575738992008,1,2,3,6,3,6,9,18,1.9241861528712412e-05
5,Austria,AUT,Winter,1960,935460.4269,7047539.0,0.13273575738992008,1,2,3,6,3,6,9,18,1.9241861528712412e-05
6,Belgium,BEL,Summer,1960,1273691.659,9153489.0,0.13914821539633684,0,2,2,4,0,6,6,12,9.421432507002074e-06
7,Brazil,BRA,Summer,1960,232998.7625,73092515.0,0.003187723975567129,0,0,2,2,0,0,6,6,2.5751209730137514e-05
8,Canada,CAN,Summer,1960,2259250.5110000004,17909356.0,0.1261491764974687,0,1,0,1,0,3,0,3,1.3278739942265745e-06
9,Canada,CAN,Summer,1960,2259250.5110000004,17909356.0,0.1261491764974687,0,1,0,1,0,3,0,3,1.3278739942265745e-06
10,Canada,CAN,Winter,1960,2259250.5110000004,17909356.0,0.1261491764974687,2,1,1,4,6,3,3,12,5.311495976906298e-06
11,Canada,CAN,Winter,1960,2259250.5110000004,17909356.0,0.1261491764974687,2,1,1,4,6,3,3,12,5.311495976906298e-06
12,Spain,ESP,Summer,1960,396392.2533,30455000.0,0.013015670769988507,0,0,1,1,0,0,3,3,7.568260920905338e-06
13,Ethiopia,ETH,Summer,1960,0.0,21739710.0,0.0,1,0,0,1,3,0,0,3,0.0
14,Finland,FIN,Summer,1960,1179353.011,4429634.0,0.26624163779671184,1,1,3,5,3,3,9,15,1.271883809181202e-05
15,Finland,FIN,Summer,1960,1179353.011,4429634.0,0.26624163779671184,1,1,3,5,3,3,9,15,1.271883809181202e-05
16,Finland,FIN,Winter,1960,1179353.011,4429634.0,0.26624163779671184,2,3,3,8,6,9,9,24,2.0350140946899232e-05
17,Finland,FIN,Winter,1960,1179353.011,4429634.0,0.26624163779671184,2,3,3,8,6,9,9,24,2.0350140946899232e-05
18,France,FRA,Summer,1960,1333881.5729999999,46649927.0,0.028593433233025205,0,2,3,5,0,6,9,15,1.12453761290546e-05
19,France,FRA,Summer,1960,1333881.5729999999,46649927.0,0.028593433233025205,0,2,3,5,0,6,9,15,1.12453761290546e-05
20,France,FRA,Winter,1960,1333881.5729999999,46649927.0,0.028593433233025205,1,0,2,3,3,0,6,9,6.74722567743276e-06
21,France,FRA,Winter,1960,1333881.5729999999,46649927.0,0.028593433233025205,1,0,2,3,3,0,6,9,6.74722567743276e-06
22,United Kingdom,GBR,Summer,1960,1397594.8029999998,52400000.0,0.026671656545801524,2,6,12,20,6,18,36,60,4.2930898047994534e-05
23,Ghana,GHA,Summer,1960,176095.64839999998,6911510.0,0.025478607192928892,0,1,0,1,0,3,0,3,1.7036196108523488e-05
24,Hungary,HUN,Summer,1960,0.0,9983967.0,0.0,6,8,7,21,18,24,21,63,0.0
25,India,IND,Summer,1960,83035.10182,445954579.0,0.00018619632072440273,0,1,0,1,0,3,0,3,3.6129298745285745e-05
26,Iraq,IRQ,Summer,1960,237713.20789999998,7084678.0,0.033553142132924034,0,0,1,1,0,0,3,3,1.2620249528844123e-05
27,Italy,ITA,Summer,1960,804492.6233,50199700.0,0.016025845240110997,13,10,13,36,39,30,39,108,0.00013424610353416028
28,Italy,ITA,Summer,1960,804492.6233,50199700.0,0.016025845240110997,13,10,13,36,39,30,39,108,0.00013424610353416028
29,Italy,ITA,Winter,1960,804492.6233,50199700.0,0.016025845240110997,0,0,1,1,0,0,3,3,3.7290584315044523e-06
30,Italy,ITA,Winter,1960,804492.6233,50199700.0,0.016025845240110997,0,0,1,1,0,0,3,3,3.7290584315044523e-06
31,Japan,JPN,Summer,1960,475319.07560000004,93216000.0,0.005099114697047717,4,7,7,18,12,21,21,54,0.00011360789577366584
32,Morocco,MAR,Summer,1960,172598.98380000002,11769774.0,0.014664596261576478,0,1,0,1,0,3,0,3,1.7381330607810912e-05
33,Mexico,MEX,Summer,1960,359545.05970000004,36268055.0,0.009913546775530148,0,0,1,1,0,0,3,3,8.343877683935258e-06
34,Norway,NOR,Summer,1960,1441755.6600000001,3581239.0,0.4025857140503608,1,0,0,1,3,0,0,3,2.0807964090114964e-06
35,Norway,NOR,Summer,1960,1441755.6600000001,3581239.0,0.4025857140503608,1,0,0,1,3,0,0,3,2.0807964090114964e-06
36,Norway,NOR,Winter,1960,1441755.6600000001,3581239.0,0.4025857140503608,3,3,0,6,9,9,0,18,1.2484778454068977e-05
37,Norway,NOR,Winter,1960,1441755.6600000001,3581239.0,0.4025857140503608,3,3,0,6,9,9,0,18,1.2484778454068977e-05
38,New Zealand,NZL,Summer,1960,2312949.9919999996,2371800.0,0.9751876178429882,2,0,1,3,6,0,3,9,3.891134711571404e-06
39,Pakistan,PAK,Summer,1960,81586.9473,45954226.0,0.0017753959624953752,1,0,1,2,3,0,3,6,7.354117537867482e-05
40,Poland,POL,Summer,1960,0.0,29637450.0,0.0,4,6,11,21,12,18,33,63,0.0
41,Poland,POL,Summer,1960,0.0,29637450.0,0.0,4,6,11,21,12,18,33,63,0.0
42,Poland,POL,Winter,1960,0.0,29637450.0,0.0,0,1,1,2,0,3,3,6,0.0
43,Poland,POL,Winter,1960,0.0,29637450.0,0.0,0,1,1,2,0,3,3,6,0.0
44,Romania,ROU,Summer,1960,0.0,18406905.0,0.0,3,1,6,10,9,3,18,30,0.0
45,Singapore,SGP,Summer,1960,428058.98000000004,1646400.0,0.25999695092322644,0,1,0,1,0,3,0,3,7.008380013427121e-06
46,Sweden,SWE,Summer,1960,2114002.973,7484656.0,0.2824449076884763,1,2,3,6,3,6,9,18,8.5146521693184e-06
47,Sweden,SWE,Summer,1960,2114002.973,7484656.0,0.2824449076884763,1,2,3,6,3,6,9,18,8.5146521693184e-06
48,Sweden,SWE,Winter,1960,2114002.973,7484656.0,0.2824449076884763,3,2,2,7,9,6,6,21,9.9337608642048e-06
49,Sweden,SWE,Winter,1960,2114002.973,7484656.0,0.2824449076884763,3,2,2,7,9,6,6,21,9.9337608642048e-06
50,Turkiye,TUR,Summer,1960,508290.6132,27510980.0,0.01847591809524779,7,2,0,9,21,6,0,27,5.311921821656021e-05
51,United States,USA,Summer,1960,3007123.4450000003,180671000.0,0.01664419549900095,34,21,16,71,102,63,48,213,7.083181116297671e-05
52,United States,USA,Summer,1960,3007123.4450000003,180671000.0,0.01664419549900095,34,21,16,71,102,63,48,213,7.083181116297671e-05
53,United States,USA,Winter,1960,3007123.4450000003,180671000.0,0.01664419549900095,3,4,3,10,9,12,9,30,9.97631143140517e-06
54,United States,USA,Winter,1960,3007123.4450000003,180671000.0,0.01664419549900095,3,4,3,10,9,12,9,30,9.97631143140517e-06
55,"Venezuela, RB",VEN,Summer,1960,953677.9441999999,8156937.0,0.1169161836360879,0,0,1,1,0,0,3,3,3.1457160336412868e-06
56,Argentina,ARG,Summer,1964,1179504.098,21708487.0,0.05433377729180297,0,1,0,1,0,3,0,3,2.5434417778512883e-06
57,Australia,AUS,Summer,1964,2131277.657,11167000.0,0.1908549885376556,6,2,10,18,18,6,30,54,2.5336914607367837e-05
58,Austria,AUT,Winter,1964,1269412.583,7223801.0,0.17572640539239662,4,5,3,12,12,15,9,36,2.8359573933733408e-05
59,Belgium,BEL,Summer,1964,1701846.276,9378113.0,0.1814700117177091,2,0,1,3,6,0,3,9,5.288374236216855e-06
60,Brazil,BRA,Summer,1964,254838.581,82262794.0,0.0030978595378124405,0,0,1,1,0,0,3,3,1.1772157842928815e-05
61,Canada,CAN,Summer,1964,2555111.146,19325000.0,0.13221791182406212,1,2,1,4,3,6,3,12,4.696468886993771e-06
62,Canada,CAN,Summer,1964,2555111.146,19325000.0,0.13221791182406212,1,2,1,4,3,6,3,12,4.696468886993771e-06
63,Canada,CAN,Winter,1964,2555111.146,19325000.0,0.13221791182406212,1,1,1,3,3,3,3,9,3.5223516652453285e-06
64,Canada,CAN,Winter,1964,2555111.146,19325000.0,0.13221791182406212,1,1,1,3,3,3,3,9,3.5223516652453285e-06
65,Cuba,CUB,Summer,1964,0.0,7902286.0,0.0,0,1,0,1,0,3,0,3,0.0
66,Ethiopia,ETH,Summer,1964,0.0,24073696.0,0.0,1,0,0,1,3,0,0,3,0.0
67,Finland,FIN,Summer,1964,1707503.938,4548543.0,0.3753957999297797,3,0,2,5,9,0,6,15,8.7847527997912e-06
68,Finland,FIN,Summer,1964,1707503.938,4548543.0,0.3753957999297797,3,0,2,5,9,0,6,15,8.7847527997912e-06
69,Finland,FIN,Winter,1964,1707503.938,4548543.0,0.3753957999297797,3,4,3,10,9,12,9,30,1.75695055995824e-05
70,Finland,FIN,Winter,1964,1707503.938,4548543.0,0.3753957999297797,3,4,3,10,9,12,9,30,1.75695055995824e-05
71,France,FRA,Summer,1964,1928999.402,48733997.0,0.03958221202336431,1,8,6,15,3,24,18,45,2.332815653200498e-05
72,France,FRA,Summer,1964,1928999.402,48733997.0,0.03958221202336431,1,8,6,15,3,24,18,45,2.332815653200498e-05
73,France,FRA,Winter,1964,1928999.402,48733997.0,0.03958221202336431,3,4,0,7,9,12,0,21,1.088647304826899e-05
74,France,FRA,Winter,1964,1928999.402,48733997.0,0.03958221202336431,3,4,0,7,9,12,0,21,1.088647304826899e-05
75,United Kingdom,GBR,Summer,1964,1748288.118,54000000.0,0.03237570588888889,4,12,2,18,12,36,6,54,3.088735743498315e-05
76,United Kingdom,GBR,Summer,1964,1748288.118,54000000.0,0.03237570588888889,4,12,2,18,12,36,6,54,3.088735743498315e-05
77,United Kingdom,GBR,Winter,1964,1748288.118,54000000.0,0.03237570588888889,1,0,0,1,3,0,0,3,1.7159643019435083e-06
78,United Kingdom,GBR,Winter,1964,1748288.118,54000000.0,0.03237570588888889,1,0,0,1,3,0,0,3,1.7159643019435083e-06
79,Ghana,GHA,Summer,1964,226576.967,7640196.0,0.02965591026722351,0,0,1,1,0,0,3,3,1.3240533844731005e-05
80,Hungary,HUN,Summer,1964,0.0,10119835.0,0.0,10,7,5,22,30,21,15,66,0.0
81,India,IND,Summer,1964,115487.6084,489059309.0,0.00023614233749305854,1,0,0,1,3,0,0,3,2.5976812937447583e-05
82,Ireland,IRL,Summer,1964,965135.4227,2866550.0,0.33668884990668224,0,0,1,1,0,0,3,3,3.1083720786119274e-06
83,Italy,ITA,Summer,1964,1222544.54,51675350.0,0.02365817628714658,10,10,7,27,30,30,21,81,6.625525479832416e-05
84,Italy,ITA,Summer,1964,1222544.54,51675350.0,0.02365817628714658,10,10,7,27,30,30,21,81,6.625525479832416e-05
85,Italy,ITA,Winter,1964,1222544.54,51675350.0,0.02365817628714658,0,1,3,4,0,3,9,12,9.81559330345543e-06
86,Italy,ITA,Winter,1964,1222544.54,51675350.0,0.02365817628714658,0,1,3,4,0,3,9,12,9.81559330345543e-06
87,Japan,JPN,Summer,1964,843616.8785,96903000.0,0.008705787008658143,16,5,8,29,48,15,24,87,0.00010312738189246649
88,Kenya,KEN,Summer,1964,110392.0208,9047387.0,0.01220153628887545,0,0,1,1,0,0,3,3,2.717587718984849e-05
89,"Korea, Rep.",KOR,Summer,1964,123606.83690000001,27984155.0,0.0044170294547039215,0,2,1,3,0,6,3,9,7.281150643213328e-05
90,Mexico,MEX,Summer,1964,485800.05,41333878.0,0.011753072140968723,0,0,1,1,0,0,3,3,6.17538017956153e-06
91,Norway,NOR,Winter,1964,1937884.614,3694339.0,0.5245551677850896,3,6,6,15,9,18,18,45,2.3221196801348875e-05
92,New Zealand,NZL,Summer,1964,2813546.9760000003,2585400.0,1.088244362961244,3,0,2,5,9,0,6,15,5.331348695419827e-06
93,Pakistan,PAK,Summer,1964,102961.2072,50552592.0,0.0020367146990207742,0,1,0,1,0,3,0,3,2.9137187505703603e-05
94,Poland,POL,Summer,1964,0.0,31139450.0,0.0,7,6,10,23,21,18,30,69,0.0
95,"Korea, Dem. People's Rep.",PRK,Winter,1964,0.0,12787523.0,0.0,0,1,0,1,0,3,0,3,0.0
96,Romania,ROU,Summer,1964,0.0,18919126.0,0.0,2,4,6,12,6,12,18,36,0.0
97,Sweden,SWE,Summer,1964,2941048.8989999997,7661354.0,0.3838810866851995,2,2,4,8,6,6,12,24,8.160353949966746e-06
98,Sweden,SWE,Summer,1964,2941048.8989999997,7661354.0,0.3838810866851995,2,2,4,8,6,6,12,24,8.160353949966746e-06
99,Sweden,SWE,Winter,1964,2941048.8989999997,7661354.0,0.3838810866851995,3,3,1,7,9,9,3,21,7.140309706220903e-06
100,Sweden,SWE,Winter,1964,2941048.8989999997,7661354.0,0.3838810866851995,3,3,1,7,9,9,3,21,7.140309706220903e-06
101,Trinidad and Tobago,TTO,Summer,1964,779389.2566,913399.0,0.8532845520960719,0,1,2,3,0,3,6,9,1.1547503283868078e-05
102,Tunisia,TUN,Summer,1964,0.0,4389417.0,0.0,0,1,1,2,0,3,3,6,0.0
103,Turkiye,TUR,Summer,1964,365133.8692,30612821.0,0.011927481926608464,2,3,1,6,6,9,3,18,4.929698808669157e-05
104,United States,USA,Summer,1964,3573941.185,191889000.0,0.01862504460912298,36,26,28,90,108,78,84,270,7.554685038836194e-05
105,United States,USA,Summer,1964,3573941.185,191889000.0,0.01862504460912298,36,26,28,90,108,78,84,270,7.554685038836194e-05
106,United States,USA,Winter,1964,3573941.185,191889000.0,0.01862504460912298,1,2,4,7,3,6,12,21,5.87586614131704e-06
107,United States,USA,Winter,1964,3573941.185,191889000.0,0.01862504460912298,1,2,4,7,3,6,12,21,5.87586614131704e-06
108,Argentina,ARG,Summer,1968,1143810.428,23112971.0,0.04948781478590528,0,0,2,2,0,0,6,6,5.245624496090011e-06
109,Australia,AUS,Summer,1968,2723999.484,12009000.0,0.226829834624032,5,7,5,17,15,21,15,51,1.87224705068997e-05
110,Austria,AUT,Summer,1968,1677673.528,7415403.0,0.22624171983639998,0,2,2,4,0,6,6,12,7.152762322181673e-06
111,Austria,AUT,Summer,1968,1677673.528,7415403.0,0.22624171983639998,0,2,2,4,0,6,6,12,7.152762322181673e-06
112,Austria,AUT,Winter,1968,1677673.528,7415403.0,0.22624171983639998,3,4,4,11,9,12,12,33,1.96700963859996e-05
113,Austria,AUT,Winter,1968,1677673.528,7415403.0,0.22624171983639998,3,4,4,11,9,12,12,33,1.96700963859996e-05
114,Belgium,BEL,Summer,1968,2222361.511,9618756.0,0.23104458736659916,0,1,1,2,0,3,3,6,2.699830774742031e-06
115,Brazil,BRA,Summer,1968,370180.4118,91659246.0,0.0040386587055276455,0,1,2,3,0,3,6,9,2.431246957730031e-05
116,Canada,CAN,Summer,1968,3462678.872,20744000.0,0.16692435750096413,1,3,1,5,3,9,3,15,4.331906178564051e-06
117,Canada,CAN,Summer,1968,3462678.872,20744000.0,0.16692435750096413,1,3,1,5,3,9,3,15,4.331906178564051e-06
118,Canada,CAN,Winter,1968,3462678.872,20744000.0,0.16692435750096413,1,1,1,3,3,3,3,9,2.5991437071384307e-06
119,Canada,CAN,Winter,1968,3462678.872,20744000.0,0.16692435750096413,1,1,1,3,3,3,3,9,2.5991437071384307e-06
120,Cameroon,CMR,Summer,1968,170745.5914,6127193.0,0.027866853777904498,0,1,0,1,0,3,0,3,1.756999976047405e-05
121,Cuba,CUB,Summer,1968,0.0,8550286.0,0.0,0,4,0,4,0,12,0,12,0.0
122,Ethiopia,ETH,Summer,1968,0.0,26778653.0,0.0,1,1,0,2,3,3,0,6,0.0
123,Finland,FIN,Summer,1968,1907077.2719999999,4626469.0,0.4122101049418033,1,2,1,4,3,6,3,12,6.2923512204701064e-06
124,Finland,FIN,Summer,1968,1907077.2719999999,4626469.0,0.4122101049418033,1,2,1,4,3,6,3,12,6.2923512204701064e-06
125,Finland,FIN,Winter,1968,1907077.2719999999,4626469.0,0.4122101049418033,1,2,2,5,3,6,6,15,7.865439025587633e-06
126,Finland,FIN,Winter,1968,1907077.2719999999,4626469.0,0.4122101049418033,1,2,2,5,3,6,6,15,7.865439025587633e-06
127,France,FRA,Summer,1968,2553975.8430000003,50817020.0,0.05025827651837909,7,3,5,15,21,9,15,45,1.7619587171639505e-05
128,France,FRA,Summer,1968,2553975.8430000003,50817020.0,0.05025827651837909,7,3,5,15,21,9,15,45,1.7619587171639505e-05
129,France,FRA,Winter,1968,2553975.8430000003,50817020.0,0.05025827651837909,4,3,2,9,12,9,6,27,1.0571752302983704e-05
130,France,FRA,Winter,1968,2553975.8430000003,50817020.0,0.05025827651837909,4,3,2,9,12,9,6,27,1.0571752302983704e-05
131,United Kingdom,GBR,Summer,1968,1951758.596,55211700.0,0.03535045282068837,5,5,3,13,15,15,9,39,1.9981979369747837e-05
132,Hungary,HUN,Summer,1968,0.0,10255815.0,0.0,10,10,12,32,30,30,36,96,0.0
133,India,IND,Summer,1968,99516.83611999999,533431909.0,0.0001865595860333132,0,0,1,1,0,0,3,3,3.014565290623309e-05
134,Italy,ITA,Summer,1968,1651939.3769999999,53235750.0,0.031030639692312026,3,4,9,16,9,12,27,48,2.905675636061795e-05
135,Italy,ITA,Summer,1968,1651939.3769999999,53235750.0,0.031030639692312026,3,4,9,16,9,12,27,48,2.905675636061795e-05
136,Italy,ITA,Winter,1968,1651939.3769999999,53235750.0,0.031030639692312026,4,0,0,4,12,0,0,12,7.264189090154488e-06
137,Italy,ITA,Winter,1968,1651939.3769999999,53235750.0,0.031030639692312026,4,0,0,4,12,0,0,12,7.264189090154488e-06
138,Jamaica,JAM,Summer,1968,598100.6359,1812209.0,0.3300395461561001,0,1,0,1,0,3,0,3,5.015878298617271e-06
139,Japan,JPN,Summer,1968,1451337.703,101011000.0,0.014368115383473087,11,7,7,25,33,21,21,75,5.1676463613513666e-05
140,Kenya,KEN,Summer,1968,127502.46280000001,10613877.0,0.012012807647949944,3,4,2,9,9,12,6,27,0.0002117606154976953
141,"Korea, Rep.",KOR,Summer,1968,198431.298,30838302.0,0.006434572759550769,0,1,1,2,0,3,3,6,3.023716551004973e-05
142,Mexico,MEX,Summer,1968,622425.0634,47170337.0,0.013195264290776637,3,3,3,9,9,9,9,27,4.3378715909209e-05
143,Norway,NOR,Summer,1968,2662117.492,3816486.0,0.6975310513388494,1,1,0,2,3,3,0,6,2.253844925338855e-06
144,Norway,NOR,Summer,1968,2662117.492,3816486.0,0.6975310513388494,1,1,0,2,3,3,0,6,2.253844925338855e-06
145,Norway,NOR,Winter,1968,2662117.492,3816486.0,0.6975310513388494,6,6,2,14,18,18,6,42,1.5776914477371983e-05
146,Norway,NOR,Winter,1968,2662117.492,3816486.0,0.6975310513388494,6,6,2,14,18,18,6,42,1.5776914477371983e-05
147,New Zealand,NZL,Summer,1968,1885156.152,2748100.0,0.6859852814671955,1,0,2,3,3,0,6,9,4.774140322780009e-06
148,Pakistan,PAK,Summer,1968,143287.94629999998,56124743.0,0.002553026323880004,1,0,0,1,3,0,0,3,2.0936862293489376e-05
149,Poland,POL,Summer,1968,0.0,32294655.0,0.0,5,2,11,18,15,6,33,54,0.0
150,Romania,ROU,Summer,1968,0.0,19799831.0,0.0,4,6,5,15,12,18,15,45,0.0
151,Romania,ROU,Summer,1968,0.0,19799831.0,0.0,4,6,5,15,12,18,15,45,0.0
152,Romania,ROU,Winter,1968,0.0,19799831.0,0.0,0,0,1,1,0,0,3,3,0.0
153,Romania,ROU,Winter,1968,0.0,19799831.0,0.0,0,0,1,1,0,0,3,3,0.0
154,Sweden,SWE,Summer,1968,3926409.001,7912273.0,0.4962428623228749,2,1,1,4,6,3,3,12,3.0562277126360936e-06
155,Sweden,SWE,Summer,1968,3926409.001,7912273.0,0.4962428623228749,2,1,1,4,6,3,3,12,3.0562277126360936e-06
156,Sweden,SWE,Winter,1968,3926409.001,7912273.0,0.4962428623228749,3,2,3,8,9,6,9,24,6.112455425272187e-06
157,Sweden,SWE,Winter,1968,3926409.001,7912273.0,0.4962428623228749,3,2,3,8,9,6,9,24,6.112455425272187e-06
158,Tunisia,TUN,Summer,1968,253848.674,4785003.0,0.05305089129515697,1,0,1,2,3,0,3,6,2.3636128979740112e-05
159,Turkiye,TUR,Summer,1968,516466.80630000005,33884075.0,0.015242169257977384,2,0,0,2,6,0,0,6,1.161739714306979e-05
160,Uganda,UGA,Summer,1968,107031.3041,9696370.0,0.011038285884305157,0,1,1,2,0,3,3,6,5.6058365825330536e-05
161,United States,USA,Summer,1968,4695923.39,200706000.0,0.02339702545016093,45,28,34,107,135,84,102,321,6.835716287100672e-05
162,United States,USA,Summer,1968,4695923.39,200706000.0,0.02339702545016093,45,28,34,107,135,84,102,321,6.835716287100672e-05
163,United States,USA,Winter,1968,4695923.39,200706000.0,0.02339702545016093,1,5,1,7,3,15,3,21,4.4719639261406265e-06
164,United States,USA,Winter,1968,4695923.39,200706000.0,0.02339702545016093,1,5,1,7,3,15,3,21,4.4719639261406265e-06
165,"Venezuela, RB",VEN,Summer,1968,940201.4199,10672654.0,0.08809443460829892,1,0,0,1,3,0,0,3,3.190805647069838e-06
166,Argentina,ARG,Summer,1972,1411176.664,24612794.0,0.05733508613447137,0,1,0,1,0,3,0,3,2.125885494376344e-06
167,Australia,AUS,Summer,1972,3949461.643,13177000.0,0.299723885785839,8,7,2,17,24,21,6,51,1.2913152376195896e-05
168,Austria,AUT,Summer,1972,2924048.8789999997,7544201.0,0.38758894136039057,0,1,2,3,0,3,6,9,3.0779239241301345e-06
169,Austria,AUT,Summer,1972,2924048.8789999997,7544201.0,0.38758894136039057,0,1,2,3,0,3,6,9,3.0779239241301345e-06
170,Austria,AUT,Winter,1972,2924048.8789999997,7544201.0,0.38758894136039057,1,2,2,5,3,6,6,15,5.129873206883557e-06
171,Austria,AUT,Winter,1972,2924048.8789999997,7544201.0,0.38758894136039057,1,2,2,5,3,6,6,15,5.129873206883557e-06
172,Belgium,BEL,Summer,1972,3831631.9,9711115.0,0.3945614792946021,0,2,0,2,0,6,0,6,1.5659124249383142e-06
173,Brazil,BRA,Summer,1972,577451.5371999999,101194394.0,0.005706358962928321,0,0,2,2,0,0,6,6,1.0390482340896262e-05
174,Canada,CAN,Summer,1972,5089587.902,22218463.0,0.2290702062514405,0,2,3,5,0,6,9,15,2.947193424855795e-06
175,Canada,CAN,Summer,1972,5089587.902,22218463.0,0.2290702062514405,0,2,3,5,0,6,9,15,2.947193424855795e-06
176,Canada,CAN,Winter,1972,5089587.902,22218463.0,0.2290702062514405,0,1,0,1,0,3,0,3,5.89438684971159e-07
177,Canada,CAN,Winter,1972,5089587.902,22218463.0,0.2290702062514405,0,1,0,1,0,3,0,3,5.89438684971159e-07
178,Colombia,COL,Summer,1972,395987.6223,21898055.0,0.018083232611298128,0,1,2,3,0,3,6,9,2.2727983131709114e-05
179,Cuba,CUB,Summer,1972,887217.1977,9169289.0,0.09675965036111306,3,1,4,8,9,3,12,24,2.7050873294856104e-05
180,Spain,ESP,Summer,1972,1708808.6290000002,34604469.0,0.049381154468805755,0,0,1,1,0,0,3,3,1.7556091121541263e-06
181,Spain,ESP,Summer,1972,1708808.6290000002,34604469.0,0.049381154468805755,0,0,1,1,0,0,3,3,1.7556091121541263e-06
182,Spain,ESP,Winter,1972,1708808.6290000002,34604469.0,0.049381154468805755,1,0,0,1,3,0,0,3,1.7556091121541263e-06
183,Spain,ESP,Winter,1972,1708808.6290000002,34604469.0,0.049381154468805755,1,0,0,1,3,0,0,3,1.7556091121541263e-06
184,Ethiopia,ETH,Summer,1972,0.0,29891328.0,0.0,0,0,2,2,0,0,6,6,0.0
185,Finland,FIN,Summer,1972,3177645.701,4639657.0,0.6848880641392241,3,1,4,8,9,3,12,24,7.552761465020232e-06
186,Finland,FIN,Summer,1972,3177645.701,4639657.0,0.6848880641392241,3,1,4,8,9,3,12,24,7.552761465020232e-06
187,Finland,FIN,Winter,1972,3177645.701,4639657.0,0.6848880641392241,0,4,1,5,0,12,3,15,4.720475915637645e-06
188,Finland,FIN,Winter,1972,3177645.701,4639657.0,0.6848880641392241,0,4,1,5,0,12,3,15,4.720475915637645e-06
189,France,FRA,Summer,1972,3865925.4,52637888.0,0.073443778747354,2,4,7,13,6,12,21,39,1.0088140862728495e-05
190,France,FRA,Summer,1972,3865925.4,52637888.0,0.073443778747354,2,4,7,13,6,12,21,39,1.0088140862728495e-05
191,France,FRA,Winter,1972,3865925.4,52637888.0,0.073443778747354,0,1,2,3,0,3,6,9,2.3280325067834987e-06
192,France,FRA,Winter,1972,3865925.4,52637888.0,0.073443778747354,0,1,2,3,0,3,6,9,2.3280325067834987e-06
193,United Kingdom,GBR,Summer,1972,3030432.514,56086065.0,0.05403182615860107,4,5,9,18,12,15,27,54,1.781923859070633e-05
194,Ghana,GHA,Summer,1972,225528.9099,9365952.0,0.0240796568143847,0,0,1,1,0,0,3,3,1.3302064029530434e-05
195,Hungary,HUN,Summer,1972,0.0,10398489.0,0.0,6,13,16,35,18,39,48,105,0.0
196,India,IND,Summer,1972,122612.45340000001,582837973.0,0.00021037142238499964,0,0,1,1,0,0,3,3,2.4467335224204882e-05
197,Italy,ITA,Summer,1972,2671137.3140000002,54381345.0,0.049118632759083104,5,3,10,18,15,9,30,54,2.0216107841770054e-05
198,Italy,ITA,Summer,1972,2671137.3140000002,54381345.0,0.049118632759083104,5,3,10,18,15,9,30,54,2.0216107841770054e-05
199,Italy,ITA,Winter,1972,2671137.3140000002,54381345.0,0.049118632759083104,2,2,1,5,6,6,3,15,5.615585511602792e-06
200,Italy,ITA,Winter,1972,2671137.3140000002,54381345.0,0.049118632759083104,2,2,1,5,6,6,3,15,5.615585511602792e-06
201,Jamaica,JAM,Summer,1972,978984.9312999999,1915299.0,0.511139478118038,0,0,1,1,0,0,3,3,3.0643985459676915e-06
202,Japan,JPN,Summer,1972,2967041.996,107188000.0,0.02768072914878531,13,8,8,29,39,24,24,87,2.9322132992147915e-05
203,Japan,JPN,Summer,1972,2967041.996,107188000.0,0.02768072914878531,13,8,8,29,39,24,24,87,2.9322132992147915e-05
204,Japan,JPN,Winter,1972,2967041.996,107188000.0,0.02768072914878531,1,1,1,3,3,3,3,9,3.0333241026359915e-06
205,Japan,JPN,Winter,1972,2967041.996,107188000.0,0.02768072914878531,1,1,1,3,3,3,3,9,3.0333241026359915e-06
206,Kenya,KEN,Summer,1972,171005.09170000002,12322903.0,0.013877013533255923,2,3,4,9,6,9,12,27,0.00015789003550471472
207,"Korea, Rep.",KOR,Summer,1972,324196.2768,33505406.0,0.009675939363337367,0,1,0,1,0,3,0,3,9.253653464536025e-06
208,Lebanon,LBN,Summer,1972,0.0,2505965.0,0.0,0,1,0,1,0,3,0,3,0.0
209,Mexico,MEX,Summer,1972,844174.4381,53543436.0,0.015766161105163292,0,1,0,1,0,3,0,3,3.553767876165688e-06
210,Norway,NOR,Summer,1972,4413575.692000001,3933004.0,1.122189474508544,2,1,1,4,6,3,3,12,2.718883924830171e-06
211,Norway,NOR,Summer,1972,4413575.692000001,3933004.0,1.122189474508544,2,1,1,4,6,3,3,12,2.718883924830171e-06
212,Norway,NOR,Winter,1972,4413575.692000001,3933004.0,1.122189474508544,2,5,5,12,6,15,15,36,8.156651774490513e-06
213,Norway,NOR,Winter,1972,4413575.692000001,3933004.0,1.122189474508544,2,5,5,12,6,15,15,36,8.156651774490513e-06
214,New Zealand,NZL,Summer,1972,3294648.943,2903900.0,1.1345600547539516,1,1,1,3,3,3,3,9,2.731702271078658e-06
215,Pakistan,PAK,Summer,1972,150617.2113,62509565.0,0.0024095066299053593,0,1,0,1,0,3,0,3,1.9918042394401976e-05
216,Poland,POL,Summer,1972,0.0,33055650.0,0.0,7,5,9,21,21,15,27,63,0.0
217,Poland,POL,Summer,1972,0.0,33055650.0,0.0,7,5,9,21,21,15,27,63,0.0
218,Poland,POL,Winter,1972,0.0,33055650.0,0.0,1,0,0,1,3,0,0,3,0.0
219,Poland,POL,Winter,1972,0.0,33055650.0,0.0,1,0,0,1,3,0,0,3,0.0
220,"Korea, Dem. People's Rep.",PRK,Summer,1972,0.0,15768363.0,0.0,1,1,3,5,3,3,9,15,0.0
221,Romania,ROU,Summer,1972,0.0,20657957.0,0.0,3,6,7,16,9,18,21,48,0.0
222,Sweden,SWE,Summer,1972,6027128.499000001,8122300.0,0.7420470185784815,4,6,6,16,12,18,18,48,7.963991477527645e-06
223,Sweden,SWE,Summer,1972,6027128.499000001,8122300.0,0.7420470185784815,4,6,6,16,12,18,18,48,7.963991477527645e-06
224,Sweden,SWE,Winter,1972,6027128.499000001,8122300.0,0.7420470185784815,1,1,2,4,3,3,6,12,1.9909978693819114e-06
225,Sweden,SWE,Winter,1972,6027128.499000001,8122300.0,0.7420470185784815,1,1,2,4,3,3,6,12,1.9909978693819114e-06
226,Tunisia,TUN,Summer,1972,420566.5745,5320148.0,0.07905166820547098,0,1,0,1,0,3,0,3,7.1332345029241025e-06
227,Turkiye,TUR,Summer,1972,547465.1976,37188035.0,0.014721541420513344,0,1,0,1,0,3,0,3,5.479800383935858e-06
228,Uganda,UGA,Summer,1972,137025.2176,10885563.0,0.012587793355290857,1,1,0,2,3,3,0,6,4.3787560458506434e-05
229,United States,USA,Summer,1972,6094017.99,209896000.0,0.02903351178678965,33,31,30,94,99,93,90,282,4.627488800701752e-05
230,United States,USA,Summer,1972,6094017.99,209896000.0,0.02903351178678965,33,31,30,94,99,93,90,282,4.627488800701752e-05
231,United States,USA,Winter,1972,6094017.99,209896000.0,0.02903351178678965,3,2,3,8,9,6,9,24,3.938288341022767e-06
232,United States,USA,Winter,1972,6094017.99,209896000.0,0.02903351178678965,3,2,3,8,9,6,9,24,3.938288341022767e-06
233,Australia,AUS,Summer,1976,7487078.975000001,14033000.0,0.5335337401125918,0,1,4,5,0,3,12,15,2.0034515530137036e-06
234,Austria,AUT,Summer,1976,5678386.658000001,7565525.0,0.7505608213574075,0,0,1,1,0,0,3,3,5.283190773515655e-07
235,Austria,AUT,Summer,1976,5678386.658000001,7565525.0,0.7505608213574075,0,0,1,1,0,0,3,3,5.283190773515655e-07
236,Austria,AUT,Winter,1976,5678386.658000001,7565525.0,0.7505608213574075,2,2,2,6,6,6,6,18,3.169914464109393e-06
237,Austria,AUT,Winter,1976,5678386.658000001,7565525.0,0.7505608213574075,2,2,2,6,6,6,6,18,3.169914464109393e-06
238,Belgium,BEL,Summer,1976,7243047.341,9818227.0,0.7377143898791503,0,3,3,6,0,9,9,18,2.485141840521901e-06
239,Brazil,BRA,Summer,1976,1376347.9279999998,111286504.0,0.01236760863653332,0,0,2,2,0,0,6,6,4.359362831111118e-06
240,Canada,CAN,Summer,1976,8809264.66,23449808.0,0.37566468177479323,0,5,6,11,0,15,18,33,3.746056143578277e-06
241,Canada,CAN,Summer,1976,8809264.66,23449808.0,0.37566468177479323,0,5,6,11,0,15,18,33,3.746056143578277e-06
242,Canada,CAN,Winter,1976,8809264.66,23449808.0,0.37566468177479323,1,1,1,3,3,3,3,9,1.0216516755213482e-06
243,Canada,CAN,Winter,1976,8809264.66,23449808.0,0.37566468177479323,1,1,1,3,3,3,3,9,1.0216516755213482e-06
244,Cuba,CUB,Summer,1976,1436285.607,9600862.0,0.14959965126048058,6,4,3,13,18,12,9,39,2.7153373820587202e-05
245,Spain,ESP,Summer,1976,3279312.671,36137812.0,0.09074463808157505,0,2,0,2,0,6,0,6,1.8296516989855524e-06
246,Finland,FIN,Summer,1976,6739690.7129999995,4725664.0,1.4261891478107627,4,2,0,6,12,6,0,18,2.670745701324292e-06
247,Finland,FIN,Summer,1976,6739690.7129999995,4725664.0,1.4261891478107627,4,2,0,6,12,6,0,18,2.670745701324292e-06
248,Finland,FIN,Winter,1976,6739690.7129999995,4725664.0,1.4261891478107627,2,4,1,7,6,12,3,21,3.1158699848783406e-06
249,Finland,FIN,Winter,1976,6739690.7129999995,4725664.0,1.4261891478107627,2,4,1,7,6,12,3,21,3.1158699848783406e-06
250,France,FRA,Summer,1976,6899069.578,53966558.0,0.12783971840486844,2,3,4,9,6,9,12,27,3.9135711989481255e-06
251,France,FRA,Summer,1976,6899069.578,53966558.0,0.12783971840486844,2,3,4,9,6,9,12,27,3.9135711989481255e-06
252,France,FRA,Winter,1976,6899069.578,53966558.0,0.12783971840486844,0,0,1,1,0,0,3,3,4.3484124432756957e-07
253,France,FRA,Winter,1976,6899069.578,53966558.0,0.12783971840486844,0,0,1,1,0,0,3,3,4.3484124432756957e-07
254,United Kingdom,GBR,Summer,1976,4138167.7879999997,56211968.0,0.07361720173184472,3,5,5,13,9,15,15,39,9.424460775392803e-06
255,United Kingdom,GBR,Summer,1976,4138167.7879999997,56211968.0,0.07361720173184472,3,5,5,13,9,15,15,39,9.424460775392803e-06
256,United Kingdom,GBR,Winter,1976,4138167.7879999997,56211968.0,0.07361720173184472,1,0,0,1,3,0,0,3,7.249585211840618e-07
257,United Kingdom,GBR,Winter,1976,4138167.7879999997,56211968.0,0.07361720173184472,1,0,0,1,3,0,0,3,7.249585211840618e-07
258,Hungary,HUN,Summer,1976,0.0,10598677.0,0.0,4,5,13,22,12,15,39,66,0.0
259,Italy,ITA,Summer,1976,4033099.354,55718260.0,0.072383799386413,2,7,4,13,6,21,12,39,9.669982456871555e-06
260,Italy,ITA,Summer,1976,4033099.354,55718260.0,0.072383799386413,2,7,4,13,6,21,12,39,9.669982456871555e-06
261,Italy,ITA,Winter,1976,4033099.354,55718260.0,0.072383799386413,1,2,1,4,3,6,3,12,2.97537921749894e-06
262,Italy,ITA,Winter,1976,4033099.354,55718260.0,0.072383799386413,1,2,1,4,3,6,3,12,2.97537921749894e-06
263,Jamaica,JAM,Summer,1976,1461458.8269999998,2029486.0,0.7201127906277747,1,1,0,2,3,3,0,6,4.105486852692567e-06
264,Japan,JPN,Summer,1976,5197622.336999999,112775000.0,0.04608842684105519,9,6,10,25,27,18,30,75,1.44296747892016e-05
265,"Korea, Rep.",KOR,Summer,1976,834134.208,35848523.0,0.023268300565688578,1,1,4,6,3,3,12,18,2.1579261259598168e-05
266,Liechtenstein,LIE,Winter,1976,11637080.59,23416.0,496.9713268705159,0,0,2,2,0,0,6,6,5.155932326494269e-07
267,Mexico,MEX,Summer,1976,1472658.876,60452543.0,0.024360577784130602,1,0,1,2,3,0,3,6,4.074263291915269e-06
268,Norway,NOR,Summer,1976,8927201.627,4026152.0,2.217303675320753,1,1,0,2,3,3,0,6,6.721031125647723e-07
269,Norway,NOR,Summer,1976,8927201.627,4026152.0,2.217303675320753,1,1,0,2,3,3,0,6,6.721031125647723e-07
270,Norway,NOR,Winter,1976,8927201.627,4026152.0,2.217303675320753,3,3,1,7,9,9,3,21,2.352360893976703e-06
271,Norway,NOR,Winter,1976,8927201.627,4026152.0,2.217303675320753,3,3,1,7,9,9,3,21,2.352360893976703e-06
272,New Zealand,NZL,Summer,1976,4373840.998,3110500.0,1.4061536723999355,2,1,1,4,6,3,3,12,2.743583958696068e-06
273,Pakistan,PAK,Summer,1976,187496.9066,70230923.0,0.0026697200975131707,0,0,1,1,0,0,3,3,1.600026397448842e-05
274,Poland,POL,Summer,1976,0.0,34356300.0,0.0,7,6,13,26,21,18,39,78,0.0
275,"Korea, Dem. People's Rep.",PRK,Summer,1976,0.0,16987170.0,0.0,1,1,0,2,3,3,0,6,0.0
276,Romania,ROU,Summer,1976,0.0,21551634.0,0.0,4,9,14,27,12,27,42,81,0.0
277,Sweden,SWE,Summer,1976,10868275.77,8222286.0,1.3218070704424536,4,1,0,5,12,3,0,15,1.3801637276636753e-06
278,Sweden,SWE,Summer,1976,10868275.77,8222286.0,1.3218070704424536,4,1,0,5,12,3,0,15,1.3801637276636753e-06
279,Sweden,SWE,Winter,1976,10868275.77,8222286.0,1.3218070704424536,0,0,2,2,0,0,6,6,5.520654910654701e-07
280,Sweden,SWE,Winter,1976,10868275.77,8222286.0,1.3218070704424536,0,0,2,2,0,0,6,6,5.520654910654701e-07
281,Thailand,THA,Summer,1976,405547.9499,41882128.0,0.00968307889942937,0,0,1,1,0,0,3,3,7.397399002361471e-06
282,Trinidad and Tobago,TTO,Summer,1976,2341875.013,1067696.0,2.1933912021773985,1,0,0,1,3,0,0,3,1.2810248127447784e-06
283,United States,USA,Summer,1976,8592253.537,218035000.0,0.039407680129337035,34,35,25,94,102,105,75,282,3.282026057374242e-05
284,United States,USA,Summer,1976,8592253.537,218035000.0,0.039407680129337035,34,35,25,94,102,105,75,282,3.282026057374242e-05
285,United States,USA,Winter,1976,8592253.537,218035000.0,0.039407680129337035,3,3,4,10,9,9,12,30,3.491517082313024e-06
286,United States,USA,Winter,1976,8592253.537,218035000.0,0.039407680129337035,3,3,4,10,9,9,12,30,3.491517082313024e-06
287,"Venezuela, RB",VEN,Summer,1976,2316030.922,13566112.0,0.17072178985401268,0,1,0,1,0,3,0,3,1.2953194931479417e-06
288,Australia,AUS,Summer,1980,10208576.17,14692000.0,0.6948391076776477,2,2,5,9,6,6,15,27,2.644835043631751e-06
289,Austria,AUT,Summer,1980,10869546.49,7549433.0,1.4397831585497878,1,2,1,4,3,6,3,12,1.1040019021069572e-06
290,Austria,AUT,Summer,1980,10869546.49,7549433.0,1.4397831585497878,1,2,1,4,3,6,3,12,1.1040019021069572e-06
291,Austria,AUT,Winter,1980,10869546.49,7549433.0,1.4397831585497878,3,2,2,7,9,6,6,21,1.932003328687175e-06
292,Austria,AUT,Winter,1980,10869546.49,7549433.0,1.4397831585497878,3,2,2,7,9,6,6,21,1.932003328687175e-06
293,Belgium,BEL,Summer,1980,12864002.57,9859242.0,1.3047658805818947,1,0,0,1,3,0,0,3,2.3320890863285952e-07
294,Brazil,BRA,Summer,1980,1941259.538,122288383.0,0.01587443950420049,2,0,2,4,6,0,6,12,6.181553658900812e-06
295,Canada,CAN,Winter,1980,11170563.969999999,24515667.0,0.45565001229621854,0,1,1,2,0,3,3,6,5.371259692987552e-07
296,Cuba,CUB,Summer,1980,2030041.0489999999,9809107.0,0.20695472574618667,8,7,5,20,24,21,15,60,2.9556052587978974e-05
297,Spain,ESP,Summer,1980,6208578.018999999,37491165.0,0.1656010961249137,1,3,2,6,3,9,6,18,2.899214593891697e-06
298,Ethiopia,ETH,Summer,1980,0.0,34945469.0,0.0,2,0,2,4,6,0,6,12,0.0
299,Finland,FIN,Summer,1980,11223937.56,4779535.0,2.3483325386256197,3,1,4,8,9,3,12,24,2.138287020192582e-06
300,Finland,FIN,Summer,1980,11223937.56,4779535.0,2.3483325386256197,3,1,4,8,9,3,12,24,2.138287020192582e-06
301,Finland,FIN,Winter,1980,11223937.56,4779535.0,2.3483325386256197,1,5,3,9,3,15,9,27,2.405572897716655e-06
302,Finland,FIN,Winter,1980,11223937.56,4779535.0,2.3483325386256197,1,5,3,9,3,15,9,27,2.405572897716655e-06
303,France,FRA,Summer,1980,12738520.049999999,55052582.0,0.23138823988309937,6,5,3,14,18,15,9,42,3.2970863047783958e-06
304,France,FRA,Summer,1980,12738520.049999999,55052582.0,0.23138823988309937,6,5,3,14,18,15,9,42,3.2970863047783958e-06
305,France,FRA,Winter,1980,12738520.049999999,55052582.0,0.23138823988309937,0,0,1,1,0,0,3,3,2.3550616462702827e-07
306,France,FRA,Winter,1980,12738520.049999999,55052582.0,0.23138823988309937,0,0,1,1,0,0,3,3,2.3550616462702827e-07
307,United Kingdom,GBR,Summer,1980,10032062.08,56314216.0,0.1781443974999137,5,7,9,21,15,21,27,63,6.27986544517077e-06
308,United Kingdom,GBR,Summer,1980,10032062.08,56314216.0,0.1781443974999137,5,7,9,21,15,21,27,63,6.27986544517077e-06
309,United Kingdom,GBR,Winter,1980,10032062.08,56314216.0,0.1781443974999137,1,0,0,1,3,0,0,3,2.9904121167479855e-07
310,United Kingdom,GBR,Winter,1980,10032062.08,56314216.0,0.1781443974999137,1,0,0,1,3,0,0,3,2.9904121167479855e-07
311,Guyana,GUY,Summer,1980,775145.9824,778176.0,0.9961062566822929,0,0,1,1,0,0,3,3,3.870238726789794e-06
312,Hungary,HUN,Summer,1980,0.0,10711122.0,0.0,7,10,15,32,21,30,45,96,0.0
313,Hungary,HUN,Summer,1980,0.0,10711122.0,0.0,7,10,15,32,21,30,45,96,0.0
314,Hungary,HUN,Winter,1980,0.0,10711122.0,0.0,0,1,0,1,0,3,0,3,0.0
315,Hungary,HUN,Winter,1980,0.0,10711122.0,0.0,0,1,0,1,0,3,0,3,0.0
316,India,IND,Summer,1980,267390.5787,696828385.0,0.0003837251530733783,1,0,0,1,3,0,0,3,1.1219542642771504e-05
317,Ireland,IRL,Summer,1980,6372437.775,3412800.0,1.867216882032349,0,1,1,2,0,3,3,6,9.415548981174633e-07
318,Italy,ITA,Summer,1980,8456918.974,56433883.0,0.14985534442136472,8,3,4,15,24,9,12,45,5.321086809315338e-06
319,Italy,ITA,Summer,1980,8456918.974,56433883.0,0.14985534442136472,8,3,4,15,24,9,12,45,5.321086809315338e-06
320,Italy,ITA,Winter,1980,8456918.974,56433883.0,0.14985534442136472,0,2,0,2,0,6,0,6,7.094782412420451e-07
321,Italy,ITA,Winter,1980,8456918.974,56433883.0,0.14985534442136472,0,2,0,2,0,6,0,6,7.094782412420451e-07
322,Jamaica,JAM,Summer,1980,1254671.851,2135546.0,0.5875180637644892,0,0,3,3,0,0,9,9,7.173190338833863e-06
323,Japan,JPN,Winter,1980,9463353.854999999,116807000.0,0.08101700972544452,0,1,0,1,0,3,0,3,3.1701234530239387e-07
324,Lebanon,LBN,Summer,1980,0.0,2963702.0,0.0,0,0,1,1,0,0,3,3,0.0
325,Liechtenstein,LIE,Winter,1980,21385510.36,25003.0,855.317776266848,2,2,0,4,6,6,0,12,5.611275951798235e-07
326,Mexico,MEX,Summer,1980,3029887.355,67705186.0,0.04475118575111809,0,1,3,4,0,3,9,12,3.96054327900913e-06
327,Norway,NOR,Winter,1980,15772240.91,4085620.0,3.860427771060451,1,3,6,10,3,9,18,30,1.90207594286613e-06
328,Poland,POL,Summer,1980,0.0,35574150.0,0.0,3,14,15,32,9,42,45,96,0.0
329,"Korea, Dem. People's Rep.",PRK,Summer,1980,0.0,17973650.0,0.0,0,3,2,5,0,9,6,15,0.0
330,Romania,ROU,Summer,1980,0.0,22207282.0,0.0,6,6,13,25,18,18,39,75,0.0
331,Sweden,SWE,Summer,1980,17097832.65,8310531.0,2.0573694568975194,3,3,6,12,9,9,18,36,2.105530024590573e-06
332,Sweden,SWE,Summer,1980,17097832.65,8310531.0,2.0573694568975194,3,3,6,12,9,9,18,36,2.105530024590573e-06
333,Sweden,SWE,Winter,1980,17097832.65,8310531.0,2.0573694568975194,3,0,1,4,9,0,3,12,7.01843341530191e-07
334,Sweden,SWE,Winter,1980,17097832.65,8310531.0,2.0573694568975194,3,0,1,4,9,0,3,12,7.01843341530191e-07
335,Uganda,UGA,Summer,1980,93692.22855,13284026.0,0.007052999485999199,0,1,0,1,0,3,0,3,3.201973148070668e-05
336,United States,USA,Winter,1980,12574791.51,227225000.0,0.055340704191880294,6,4,2,12,18,12,6,36,2.8628705272267372e-06
337,"Venezuela, RB",VEN,Summer,1980,3886573.9560000002,15210443.0,0.2555201026031918,0,1,0,1,0,3,0,3,7.718880520383953e-07
338,Australia,AUS,Summer,1984,12421492.6,15579391.0,0.7973028342378723,4,8,12,24,12,24,36,72,5.796404853954508e-06
339,Austria,AUT,Summer,1984,8991065.04,7561434.0,1.1890687718758108,1,1,1,3,3,3,3,9,1.0009937599116736e-06
340,Austria,AUT,Summer,1984,8991065.04,7561434.0,1.1890687718758108,1,1,1,3,3,3,3,9,1.0009937599116736e-06
341,Austria,AUT,Winter,1984,8991065.04,7561434.0,1.1890687718758108,0,0,1,1,0,0,3,3,3.3366458663722447e-07
342,Austria,AUT,Winter,1984,8991065.04,7561434.0,1.1890687718758108,0,0,1,1,0,0,3,3,3.3366458663722447e-07
343,Belgium,BEL,Summer,1984,8457268.803000001,9855372.0,0.8581379579583603,1,1,2,4,3,3,6,12,1.4188977883431238e-06
344,Brazil,BRA,Summer,1984,1406689.8,133888775.0,0.010506405783457202,1,5,2,8,3,15,6,24,1.706133079233247e-05
345,Canada,CAN,Summer,1984,13877917.08,25607053.0,0.5419568225988364,10,18,16,44,30,54,48,132,9.5115138128495e-06
346,Canada,CAN,Summer,1984,13877917.08,25607053.0,0.5419568225988364,10,18,16,44,30,54,48,132,9.5115138128495e-06
347,Canada,CAN,Winter,1984,13877917.08,25607053.0,0.5419568225988364,2,1,1,4,6,3,3,12,8.646830738954091e-07
348,Canada,CAN,Winter,1984,13877917.08,25607053.0,0.5419568225988364,2,1,1,4,6,3,3,12,8.646830738954091e-07
349,China,CHN,Summer,1984,250713.96899999998,1036825000.0,0.00024180934005256432,15,8,9,32,45,24,27,96,0.0003829064666117587
350,Cote d'Ivoire,CIV,Summer,1984,711085.2016,9621405.0,0.07390658657441403,0,1,0,1,0,3,0,3,4.218903716811648e-06
351,Cameroon,CMR,Summer,1984,768983.9227,9508570.0,0.08087272036699525,0,0,1,1,0,0,3,3,3.901251913650704e-06
352,Colombia,COL,Summer,1984,1333370.911,28689032.0,0.046476678299916155,0,1,0,1,0,3,0,3,2.2499365894746145e-06
353,Dominican Republic,DOM,Summer,1984,1845560.023,6282104.0,0.29378055871090325,0,0,1,1,0,0,3,3,1.6255228562674604e-06
354,"Egypt, Arab Rep.",EGY,Summer,1984,697897.9336999999,48676443.0,0.014337488334963176,0,1,0,1,0,3,0,3,4.298622843164323e-06
355,Spain,ESP,Summer,1984,4489988.939,38330364.0,0.1171392199406194,1,2,2,5,3,6,6,15,3.3407654681975153e-06
356,Finland,FIN,Summer,1984,10833866.29,4881803.0,2.219234633187779,4,2,6,12,12,6,18,36,3.322913449026885e-06
357,Finland,FIN,Summer,1984,10833866.29,4881803.0,2.219234633187779,4,2,6,12,12,6,18,36,3.322913449026885e-06
358,Finland,FIN,Winter,1984,10833866.29,4881803.0,2.219234633187779,4,3,6,13,12,9,18,39,3.599822903112459e-06
359,Finland,FIN,Winter,1984,10833866.29,4881803.0,2.219234633187779,4,3,6,13,12,9,18,39,3.599822903112459e-06
360,France,FRA,Summer,1984,9430069.648,56275701.0,0.16756911918342873,5,7,16,28,15,21,48,84,8.907675461104929e-06
361,France,FRA,Summer,1984,9430069.648,56275701.0,0.16756911918342873,5,7,16,28,15,21,48,84,8.907675461104929e-06
362,France,FRA,Winter,1984,9430069.648,56275701.0,0.16756911918342873,0,1,2,3,0,3,6,9,9.543937994040995e-07
363,France,FRA,Winter,1984,9430069.648,56275701.0,0.16756911918342873,0,1,2,3,0,3,6,9,9.543937994040995e-07
364,United Kingdom,GBR,Summer,1984,8179194.441,56422072.0,0.14496444655559618,5,11,21,37,15,33,63,111,1.3571018613225313e-05
365,United Kingdom,GBR,Summer,1984,8179194.441,56422072.0,0.14496444655559618,5,11,21,37,15,33,63,111,1.3571018613225313e-05
366,United Kingdom,GBR,Winter,1984,8179194.441,56422072.0,0.14496444655559618,1,0,0,1,3,0,0,3,3.6678428684392734e-07
367,United Kingdom,GBR,Winter,1984,8179194.441,56422072.0,0.14496444655559618,1,0,0,1,3,0,0,3,3.6678428684392734e-07
368,Ireland,IRL,Summer,1984,5692027.386,3532423.0,1.6113663018273858,0,1,0,1,0,3,0,3,5.270529806969554e-07
369,Iceland,ISL,Summer,1984,11959540.01,239511.0,49.93315551269044,0,0,1,1,0,0,3,3,2.5084576810575847e-07
370,Italy,ITA,Summer,1984,7739715.284,56576718.0,0.13680035812611116,14,6,12,32,42,18,36,96,1.2403557040199775e-05
371,Italy,ITA,Summer,1984,7739715.284,56576718.0,0.13680035812611116,14,6,12,32,42,18,36,96,1.2403557040199775e-05
372,Italy,ITA,Winter,1984,7739715.284,56576718.0,0.13680035812611116,2,0,0,2,6,0,0,6,7.75222315012486e-07
373,Italy,ITA,Winter,1984,7739715.284,56576718.0,0.13680035812611116,2,0,0,2,6,0,0,6,7.75222315012486e-07
374,Jamaica,JAM,Summer,1984,1048351.3089999999,2264095.0,0.46303326892201957,0,1,2,3,0,3,6,9,8.584908439314021e-06
375,Japan,JPN,Summer,1984,10978919.809999999,120083000.0,0.09142776088205656,10,8,14,32,30,24,42,96,8.744029618702535e-06
376,Japan,JPN,Summer,1984,10978919.809999999,120083000.0,0.09142776088205656,10,8,14,32,30,24,42,96,8.744029618702535e-06
377,Japan,JPN,Winter,1984,10978919.809999999,120083000.0,0.09142776088205656,0,1,0,1,0,3,0,3,2.732509255844542e-07
378,Japan,JPN,Winter,1984,10978919.809999999,120083000.0,0.09142776088205656,0,1,0,1,0,3,0,3,2.732509255844542e-07
379,Kenya,KEN,Summer,1984,330154.05340000003,18753176.0,0.017605234089415042,1,0,2,3,3,0,6,9,2.726000152751721e-05
380,"Korea, Rep.",KOR,Summer,1984,2413263.9250000003,40405956.0,0.05972545050041633,6,6,7,19,18,18,21,57,2.361946383464875e-05
381,Liechtenstein,LIE,Winter,1984,19024123.97,26420.0,720.0652524602573,0,0,2,2,0,0,6,6,3.1538902971099595e-07
382,Morocco,MAR,Summer,1984,675019.2871000001,21817271.0,0.030939675594624096,2,0,0,2,6,0,0,6,8.888634909643901e-06
383,Mexico,MEX,Summer,1984,2507312.061,73489654.0,0.03411789176473739,2,3,1,6,6,9,3,18,7.1790026778003035e-06
384,Norway,NOR,Summer,1984,14989485.77,4140099.0,3.6205621580546743,0,1,2,3,0,3,6,9,6.004208642042028e-07
385,Norway,NOR,Summer,1984,14989485.77,4140099.0,3.6205621580546743,0,1,2,3,0,3,6,9,6.004208642042028e-07
386,Norway,NOR,Winter,1984,14989485.77,4140099.0,3.6205621580546743,3,2,4,9,9,6,12,27,1.8012625926126084e-06
387,Norway,NOR,Winter,1984,14989485.77,4140099.0,3.6205621580546743,3,2,4,9,9,6,12,27,1.8012625926126084e-06
388,New Zealand,NZL,Summer,1984,6713760.131,3227100.0,2.080431387623563,8,1,2,11,24,3,6,33,4.9152783769599345e-06
389,Pakistan,PAK,Summer,1984,331388.7658,94003867.0,0.003525267378628158,1,0,0,1,3,0,0,3,9.052811409456658e-06
390,Peru,PER,Summer,1984,911789.2245,19285646.0,0.04727812718847997,0,1,0,1,0,3,0,3,3.290234101686294e-06
391,Romania,ROU,Summer,1984,0.0,22640547.0,0.0,20,16,17,53,60,48,51,159,0.0
392,Sweden,SWE,Summer,1984,13099020.83,8336605.0,1.5712656207173064,2,11,6,19,6,33,18,57,4.351470292302757e-06
393,Sweden,SWE,Summer,1984,13099020.83,8336605.0,1.5712656207173064,2,11,6,19,6,33,18,57,4.351470292302757e-06
394,Sweden,SWE,Winter,1984,13099020.83,8336605.0,1.5712656207173064,4,2,2,8,12,6,6,24,1.832198017811687e-06
395,Sweden,SWE,Winter,1984,13099020.83,8336605.0,1.5712656207173064,4,2,2,8,12,6,6,24,1.832198017811687e-06
396,Syrian Arab Republic,SYR,Summer,1984,1885019.531,10183138.0,0.18511185167087002,0,1,0,1,0,3,0,3,1.5914954464203904e-06
397,Thailand,THA,Summer,1984,842069.9352000001,49636724.0,0.016964655749642142,0,1,0,1,0,3,0,3,3.562649460092017e-06
398,Turkiye,TUR,Summer,1984,1247016.105,48106764.0,0.025921845522596364,0,0,3,3,0,0,9,9,7.217228361296905e-06
399,United States,USA,Summer,1984,17121225.48,235825000.0,0.07260140137814057,83,61,30,174,249,183,90,522,3.048847178665858e-05
400,United States,USA,Summer,1984,17121225.48,235825000.0,0.07260140137814057,83,61,30,174,249,183,90,522,3.048847178665858e-05
401,United States,USA,Winter,1984,17121225.48,235825000.0,0.07260140137814057,4,4,0,8,12,12,0,24,1.401768817777406e-06
402,United States,USA,Winter,1984,17121225.48,235825000.0,0.07260140137814057,4,4,0,8,12,12,0,24,1.401768817777406e-06
403,"Venezuela, RB",VEN,Summer,1984,3539754.463,16953234.0,0.20879523417184,0,0,3,3,0,0,9,9,2.542549234438242e-06
404,Argentina,ARG,Summer,1988,3982444.4020000002,31690792.0,0.12566566345202101,0,1,1,2,0,3,3,6,1.5066123702786096e-06
405,Australia,AUS,Summer,1988,14284515.81,16532164.0,0.8640439212918527,3,6,5,14,9,18,15,42,2.9402466669957083e-06
406,Austria,AUT,Summer,1988,17578618.94,7585317.0,2.3174534353673026,1,0,0,1,3,0,0,3,1.7066187111966601e-07
407,Austria,AUT,Summer,1988,17578618.94,7585317.0,2.3174534353673026,1,0,0,1,3,0,0,3,1.7066187111966601e-07
408,Austria,AUT,Winter,1988,17578618.94,7585317.0,2.3174534353673026,3,5,2,10,9,15,6,30,1.70661871119666e-06
409,Austria,AUT,Winter,1988,17578618.94,7585317.0,2.3174534353673026,3,5,2,10,9,15,6,30,1.70661871119666e-06
410,Belgium,BEL,Summer,1988,16391093.830000002,9901664.0,1.6553878045144736,0,0,2,2,0,0,6,6,3.6605244666578786e-07
411,Brazil,BRA,Summer,1988,1781817.8760000002,145253973.0,0.012266913181094194,1,2,3,6,3,6,9,18,1.0102042550166894e-05
412,Canada,CAN,Summer,1988,18936964.1,26791747.0,0.7068208019432254,3,2,5,10,9,6,15,30,1.5842032461792541e-06
413,Canada,CAN,Summer,1988,18936964.1,26791747.0,0.7068208019432254,3,2,5,10,9,6,15,30,1.5842032461792541e-06
414,Canada,CAN,Winter,1988,18936964.1,26791747.0,0.7068208019432254,0,2,3,5,0,6,9,15,7.921016230896271e-07
415,Canada,CAN,Winter,1988,18936964.1,26791747.0,0.7068208019432254,0,2,3,5,0,6,9,15,7.921016230896271e-07
416,Channel Islands,CHI,Summer,1988,0.0,137765.0,0.0,0,1,0,1,0,3,0,3,0.0
417,China,CHN,Summer,1988,283537.69519999996,1101630000.0,0.00025738015050425276,5,11,12,28,15,33,36,84,0.00029625690489142417
418,Colombia,COL,Summer,1988,1254531.5459999999,31256727.0,0.040136369556543774,0,0,1,1,0,0,3,3,2.391330859367645e-06
419,Djibouti,DJI,Summer,1988,820576.7723000001,482337.0,1.7012519717541885,0,0,1,1,0,0,3,3,3.6559650495483564e-06
420,Spain,ESP,Summer,1988,9703123.838,38766939.0,0.25029378352518367,1,1,2,4,3,3,6,12,1.2367151239485192e-06
421,Finland,FIN,Summer,1988,22047793.32,4946481.0,4.4572683732132,1,1,2,4,3,3,6,12,5.442721557587605e-07
422,Finland,FIN,Summer,1988,22047793.32,4946481.0,4.4572683732132,1,1,2,4,3,3,6,12,5.442721557587605e-07
423,Finland,FIN,Winter,1988,22047793.32,4946481.0,4.4572683732132,4,1,2,7,12,3,6,21,9.524762725778309e-07
424,Finland,FIN,Winter,1988,22047793.32,4946481.0,4.4572683732132,4,1,2,7,12,3,6,21,9.524762725778309e-07
425,France,FRA,Summer,1988,17727510.83,57472651.0,0.3084512463153996,6,4,6,16,18,12,18,48,2.707655939985118e-06
426,France,FRA,Summer,1988,17727510.83,57472651.0,0.3084512463153996,6,4,6,16,18,12,18,48,2.707655939985118e-06
427,France,FRA,Winter,1988,17727510.83,57472651.0,0.3084512463153996,1,0,1,2,3,0,3,6,3.3845699249813973e-07
428,France,FRA,Winter,1988,17727510.83,57472651.0,0.3084512463153996,1,0,1,2,3,0,3,6,3.3845699249813973e-07
429,United Kingdom,GBR,Summer,1988,15987168.08,56928327.0,0.2808297542276273,5,10,9,24,15,30,27,72,4.503611874205053e-06
430,Hungary,HUN,Summer,1988,0.0,10596487.0,0.0,11,6,6,23,33,18,18,69,0.0
431,Italy,ITA,Summer,1988,15744661.260000002,56629288.0,0.2780303587783057,6,4,4,14,18,12,12,42,2.667570886818812e-06
432,Italy,ITA,Summer,1988,15744661.260000002,56629288.0,0.2780303587783057,6,4,4,14,18,12,12,42,2.667570886818812e-06
433,Italy,ITA,Winter,1988,15744661.260000002,56629288.0,0.2780303587783057,2,1,2,5,6,3,6,15,9.527038881495758e-07
434,Italy,ITA,Winter,1988,15744661.260000002,56629288.0,0.2780303587783057,2,1,2,5,6,3,6,15,9.527038881495758e-07
435,Jamaica,JAM,Summer,1988,1625744.27,2354805.0,0.6903944360573381,0,2,0,2,0,6,0,6,3.690617344141093e-06
436,Japan,JPN,Summer,1988,25059007.43,122578000.0,0.20443315627600384,4,3,7,14,12,9,21,42,1.6760440379501496e-06
437,Japan,JPN,Summer,1988,25059007.43,122578000.0,0.20443315627600384,4,3,7,14,12,9,21,42,1.6760440379501496e-06
438,Japan,JPN,Winter,1988,25059007.43,122578000.0,0.20443315627600384,0,0,1,1,0,0,3,3,1.1971743128215354e-07
439,Japan,JPN,Winter,1988,25059007.43,122578000.0,0.20443315627600384,0,0,1,1,0,0,3,3,1.1971743128215354e-07
440,Kenya,KEN,Summer,1988,386355.9486,21626122.0,0.01786524410617863,5,2,2,9,15,6,6,27,6.988374346981648e-05
441,"Korea, Rep.",KOR,Summer,1988,4748629.608,42031247.0,0.11297855635832076,12,10,11,33,36,30,33,99,2.0848120020398104e-05
442,Liechtenstein,LIE,Winter,1988,41574494.379999995,27944.0,1487.7789285714284,0,0,1,1,0,0,3,3,7.215962682743276e-08
443,Morocco,MAR,Summer,1988,1076092.773,23720590.0,0.045365346013737436,1,0,2,3,3,0,6,9,8.363591156652067e-06
444,Mexico,MEX,Summer,1988,2302027.017,78892015.0,0.029179467871368225,0,0,2,2,0,0,6,6,2.6063986024886867e-06
445,Norway,NOR,Summer,1988,24207281.470000003,4209488.0,5.750647458788338,2,3,0,5,6,9,0,15,6.196482665180494e-07
446,Norway,NOR,Summer,1988,24207281.470000003,4209488.0,5.750647458788338,2,3,0,5,6,9,0,15,6.196482665180494e-07
447,Norway,NOR,Winter,1988,24207281.470000003,4209488.0,5.750647458788338,0,3,2,5,0,9,6,15,6.196482665180494e-07
448,Norway,NOR,Winter,1988,24207281.470000003,4209488.0,5.750647458788338,0,3,2,5,0,9,6,15,6.196482665180494e-07
449,New Zealand,NZL,Summer,1988,13759155.629999999,3283400.0,4.190520688920022,3,2,8,13,9,6,24,39,2.8344762606628067e-06
450,Pakistan,PAK,Summer,1988,356335.2154,107967838.0,0.0033003829844217127,0,0,1,1,0,0,3,3,8.419038788047891e-06
451,Peru,PER,Summer,1988,730209.7626,21143799.0,0.03453540977191469,0,1,0,1,0,3,0,3,4.108408506232699e-06
452,Poland,POL,Summer,1988,0.0,37824487.0,0.0,2,5,9,16,6,15,27,48,0.0
453,Romania,ROU,Summer,1988,1769889.9309999999,23057662.0,0.07675929723490611,7,11,6,24,21,33,18,72,4.068049585395376e-05
454,Senegal,SEN,Summer,1988,902269.9219,7113636.0,0.12683667282104397,0,1,0,1,0,3,0,3,3.3249473657313104e-06
455,Suriname,SUR,Summer,1988,2887061.4390000002,402139.0,7.179262491327626,1,0,0,1,3,0,0,3,1.0391188630329664e-06
456,Sweden,SWE,Summer,1988,24534693.82,8436489.0,2.9081640265280972,0,4,7,11,0,12,21,33,1.3450341072974515e-06
457,Sweden,SWE,Summer,1988,24534693.82,8436489.0,2.9081640265280972,0,4,7,11,0,12,21,33,1.3450341072974515e-06
458,Sweden,SWE,Winter,1988,24534693.82,8436489.0,2.9081640265280972,4,0,2,6,12,0,6,18,7.336549676167917e-07
459,Sweden,SWE,Winter,1988,24534693.82,8436489.0,2.9081640265280972,4,0,2,6,12,0,6,18,7.336549676167917e-07
460,Thailand,THA,Summer,1988,1154579.398,53410965.0,0.02161689829045403,0,0,1,1,0,0,3,3,2.5983488058046915e-06
461,Turkiye,TUR,Summer,1988,1737948.68,52275890.0,0.03324570236872103,1,1,0,2,3,3,0,6,3.452345900110238e-06
462,United States,USA,Summer,1988,21417011.93,244499000.0,0.08759549908179584,36,31,27,94,108,93,81,282,1.3167102905003611e-05
463,United States,USA,Summer,1988,21417011.93,244499000.0,0.08759549908179584,36,31,27,94,108,93,81,282,1.3167102905003611e-05
464,United States,USA,Winter,1988,21417011.93,244499000.0,0.08759549908179584,2,1,3,6,6,3,9,18,8.404533769151241e-07
465,United States,USA,Winter,1988,21417011.93,244499000.0,0.08759549908179584,2,1,3,6,6,3,9,18,8.404533769151241e-07
466,Argentina,ARG,Summer,1992,6815618.29,33568285.0,0.20303742922821347,0,0,1,1,0,0,3,3,4.401654952422519e-07
467,Australia,AUS,Summer,1992,18624555.08,17478635.0,1.0655611882735694,7,9,11,27,21,27,33,81,4.349097181225121e-06
468,Austria,AUT,Summer,1992,24880164.12,7840709.0,3.1732033569923335,0,2,0,2,0,6,0,6,2.4115596549368743e-07
469,Austria,AUT,Summer,1992,24880164.12,7840709.0,3.1732033569923335,0,2,0,2,0,6,0,6,2.4115596549368743e-07
470,Austria,AUT,Winter,1992,24880164.12,7840709.0,3.1732033569923335,6,7,8,21,18,21,24,63,2.5321376376837177e-06
471,Austria,AUT,Winter,1992,24880164.12,7840709.0,3.1732033569923335,6,7,8,21,18,21,24,63,2.5321376376837177e-06
472,Belgium,BEL,Summer,1992,23372619.17,10045158.0,2.326754757864436,0,1,2,3,0,3,6,9,3.850659583566046e-07
473,Brazil,BRA,Summer,1992,2105107.7479999997,155900790.0,0.013502867740439286,2,1,0,3,6,3,0,9,4.275315602515183e-06
474,Canada,CAN,Summer,1992,20879848.330000002,28371264.0,0.7359505847183968,7,4,7,18,21,12,21,54,2.586225682607724e-06
475,Canada,CAN,Summer,1992,20879848.330000002,28371264.0,0.7359505847183968,7,4,7,18,21,12,21,54,2.586225682607724e-06
476,Canada,CAN,Winter,1992,20879848.330000002,28371264.0,0.7359505847183968,2,3,2,7,6,9,6,21,1.005754432125226e-06
477,Canada,CAN,Winter,1992,20879848.330000002,28371264.0,0.7359505847183968,2,3,2,7,6,9,6,21,1.005754432125226e-06
478,China,CHN,Summer,1992,366460.6923,1164970000.0,0.0003145666345914487,16,22,16,54,48,66,48,162,0.00044206651191768215
479,China,CHN,Summer,1992,366460.6923,1164970000.0,0.0003145666345914487,16,22,16,54,48,66,48,162,0.00044206651191768215
480,China,CHN,Winter,1992,366460.6923,1164970000.0,0.0003145666345914487,0,3,0,3,0,9,0,9,2.4559250662093454e-05
481,China,CHN,Winter,1992,366460.6923,1164970000.0,0.0003145666345914487,0,3,0,3,0,9,0,9,2.4559250662093454e-05
482,Colombia,COL,Summer,1992,1721291.68,33939039.0,0.050717160259016174,0,0,1,1,0,0,3,3,1.7428771862767618e-06
483,Cuba,CUB,Summer,1992,2048068.839,10783748.0,0.18992180075053683,14,6,11,31,42,18,33,93,4.540862993912286e-05
484,Spain,ESP,Summer,1992,16112188.92,39157685.0,0.4114693940665798,13,7,2,22,39,21,6,66,4.096277689375554e-06
485,Spain,ESP,Summer,1992,16112188.92,39157685.0,0.4114693940665798,13,7,2,22,39,21,6,66,4.096277689375554e-06
486,Spain,ESP,Winter,1992,16112188.92,39157685.0,0.4114693940665798,0,0,1,1,0,0,3,3,1.8619444042616153e-07
487,Spain,ESP,Winter,1992,16112188.92,39157685.0,0.4114693940665798,0,0,1,1,0,0,3,3,1.8619444042616153e-07
488,Estonia,EST,Summer,1992,0.0,1533091.0,0.0,1,0,1,2,3,0,3,6,0.0
489,Ethiopia,ETH,Summer,1992,201743.5026,52011554.0,0.0038788208981412092,1,0,2,3,3,0,6,9,4.461110213717485e-05
490,Finland,FIN,Summer,1992,22319059.46,5041992.0,4.4266352386120404,1,2,2,5,3,6,6,15,6.720713310918344e-07
491,Finland,FIN,Summer,1992,22319059.46,5041992.0,4.4266352386120404,1,2,2,5,3,6,6,15,6.720713310918344e-07
492,Finland,FIN,Winter,1992,22319059.46,5041992.0,4.4266352386120404,3,1,3,7,9,3,9,21,9.408998635285682e-07
493,Finland,FIN,Winter,1992,22319059.46,5041992.0,4.4266352386120404,3,1,3,7,9,3,9,21,9.408998635285682e-07
494,France,FRA,Summer,1992,23814227.37,58849943.0,0.4046601603335453,8,5,16,29,24,15,48,87,3.653278296553024e-06
495,France,FRA,Summer,1992,23814227.37,58849943.0,0.4046601603335453,8,5,16,29,24,15,48,87,3.653278296553024e-06
496,France,FRA,Winter,1992,23814227.37,58849943.0,0.4046601603335453,3,5,1,9,9,15,3,27,1.1337760230681798e-06
497,France,FRA,Winter,1992,23814227.37,58849943.0,0.4046601603335453,3,5,1,9,9,15,3,27,1.1337760230681798e-06
498,United Kingdom,GBR,Summer,1992,20487170.79,57580402.0,0.3558011072934155,5,3,12,20,15,9,36,60,2.9286620693027376e-06
499,Ghana,GHA,Summer,1992,394907.0373,16241548.0,0.024314618120144706,0,0,1,1,0,0,3,3,7.5967245874146895e-06
500,Hungary,HUN,Summer,1992,3735105.8200000003,10369341.0,0.36020667272876844,11,12,7,30,33,36,21,90,2.409570286284419e-05
501,Ireland,IRL,Summer,1992,15714384.75,3558430.0,4.416100569633237,1,1,0,2,3,3,0,6,3.8181577551103296e-07
502,Israel,ISR,Summer,1992,0.0,5123000.0,0.0,0,1,1,2,0,3,3,6,0.0
503,Italy,ITA,Summer,1992,23243474.53,56797087.0,0.40923708869083375,6,5,8,19,18,15,24,57,2.452301179259192e-06
504,Italy,ITA,Summer,1992,23243474.53,56797087.0,0.40923708869083375,6,5,8,19,18,15,24,57,2.452301179259192e-06
505,Italy,ITA,Winter,1992,23243474.53,56797087.0,0.40923708869083375,4,6,4,14,12,18,12,42,1.8069587636646679e-06
506,Italy,ITA,Winter,1992,23243474.53,56797087.0,0.40923708869083375,4,6,4,14,12,18,12,42,1.8069587636646679e-06
507,Jamaica,JAM,Summer,1992,1452188.3869999999,2434574.0,0.596485622125267,0,3,1,4,0,9,3,12,8.263390691885489e-06
508,Japan,JPN,Summer,1992,31414984.64,124425000.0,0.2524812910588708,3,8,11,22,9,24,33,66,2.1009082371462845e-06
509,Japan,JPN,Summer,1992,31414984.64,124425000.0,0.2524812910588708,3,8,11,22,9,24,33,66,2.1009082371462845e-06
510,Japan,JPN,Winter,1992,31414984.64,124425000.0,0.2524812910588708,1,2,4,7,3,6,12,21,6.684708027283632e-07
511,Japan,JPN,Winter,1992,31414984.64,124425000.0,0.2524812910588708,1,2,4,7,3,6,12,21,6.684708027283632e-07
512,Kenya,KEN,Summer,1992,332950.2514,24655723.0,0.013503974367330458,2,4,2,8,6,12,6,24,7.208284090215888e-05
513,"Korea, Rep.",KOR,Summer,1992,8126670.390000001,43747962.0,0.1857611193408278,12,5,12,29,36,15,36,87,1.0705491403595612e-05
514,"Korea, Rep.",KOR,Summer,1992,8126670.390000001,43747962.0,0.1857611193408278,12,5,12,29,36,15,36,87,1.0705491403595612e-05
515,"Korea, Rep.",KOR,Winter,1992,8126670.390000001,43747962.0,0.1857611193408278,2,1,1,4,6,3,3,12,1.4766195039442222e-06
516,"Korea, Rep.",KOR,Winter,1992,8126670.390000001,43747962.0,0.1857611193408278,2,1,1,4,6,3,3,12,1.4766195039442222e-06
517,Lithuania,LTU,Summer,1992,0.0,3700114.0,0.0,1,0,1,2,3,0,3,6,0.0
518,Luxembourg,LUX,Winter,1992,39570861.57,392175.0,100.9010303308472,0,2,0,2,0,6,0,6,1.516267213284232e-07
519,Morocco,MAR,Summer,1992,1317329.956,25400676.0,0.051862003830134284,1,1,1,3,3,3,3,9,6.8320013213151284e-06
520,Mexico,MEX,Summer,1992,4272785.965,84993164.0,0.05027211323724812,0,1,0,1,0,3,0,3,7.021180149378253e-07
521,Namibia,NAM,Summer,1992,2346287.909,1461687.0,1.605191746933509,0,2,0,2,0,6,0,6,2.5572309250646186e-06
522,Norway,NOR,Summer,1992,30523985.06,4286401.0,7.1211221395291755,2,4,1,7,6,12,3,21,6.879835630479109e-07
523,Norway,NOR,Summer,1992,30523985.06,4286401.0,7.1211221395291755,2,4,1,7,6,12,3,21,6.879835630479109e-07
524,Norway,NOR,Winter,1992,30523985.06,4286401.0,7.1211221395291755,9,6,5,20,27,18,15,60,1.965667322994031e-06
525,Norway,NOR,Winter,1992,30523985.06,4286401.0,7.1211221395291755,9,6,5,20,27,18,15,60,1.965667322994031e-06
526,New Zealand,NZL,Summer,1992,11793139.24,3531700.0,3.3392245207690348,1,4,5,10,3,12,15,30,2.5438519286065853e-06
527,New Zealand,NZL,Summer,1992,11793139.24,3531700.0,3.3392245207690348,1,4,5,10,3,12,15,30,2.5438519286065853e-06
528,New Zealand,NZL,Winter,1992,11793139.24,3531700.0,3.3392245207690348,0,1,0,1,0,3,0,3,2.5438519286065855e-07
529,New Zealand,NZL,Winter,1992,11793139.24,3531700.0,3.3392245207690348,0,1,0,1,0,3,0,3,2.5438519286065855e-07
530,Pakistan,PAK,Summer,1992,399465.0488,122375179.0,0.00326426528699909,0,0,1,1,0,0,3,3,7.510043767313442e-06
531,Peru,PER,Summer,1992,1560546.504,23047248.0,0.06771075245079151,0,1,0,1,0,3,0,3,1.9224034607814547e-06
532,Poland,POL,Summer,1992,2459020.685,38363667.0,0.0640976443935873,3,6,10,19,9,18,30,57,2.3179959545561934e-05
533,"Korea, Dem. People's Rep.",PRK,Summer,1992,0.0,21439991.0,0.0,4,0,5,9,12,0,15,27,0.0
534,"Korea, Dem. People's Rep.",PRK,Summer,1992,0.0,21439991.0,0.0,4,0,5,9,12,0,15,27,0.0
535,"Korea, Dem. People's Rep.",PRK,Winter,1992,0.0,21439991.0,0.0,0,0,1,1,0,0,3,3,0.0
536,"Korea, Dem. People's Rep.",PRK,Winter,1992,0.0,21439991.0,0.0,0,0,1,1,0,0,3,3,0.0
537,Qatar,QAT,Summer,1992,16223780.08,471293.0,34.42397845925995,0,0,1,1,0,0,3,3,1.8491374915136301e-07
538,Romania,ROU,Summer,1992,1102103.785,22794284.0,0.048350006738531466,4,6,8,18,12,18,24,54,4.8997200386168717e-05
539,Suriname,SUR,Summer,1992,964433.2465,419521.0,2.2988914655047066,0,0,1,1,0,0,3,3,3.1106351952166967e-06
540,Sweden,SWE,Summer,1992,32800982.689999998,8668067.0,3.7841173458857664,1,7,4,12,3,21,12,36,1.0975280936011495e-06
541,Sweden,SWE,Summer,1992,32800982.689999998,8668067.0,3.7841173458857664,1,7,4,12,3,21,12,36,1.0975280936011495e-06
542,Sweden,SWE,Winter,1992,32800982.689999998,8668067.0,3.7841173458857664,1,0,3,4,3,0,9,12,3.658426978670498e-07
543,Sweden,SWE,Winter,1992,32800982.689999998,8668067.0,3.7841173458857664,1,0,3,4,3,0,9,12,3.658426978670498e-07
544,Thailand,THA,Summer,1992,1957407.581,56939020.0,0.0343772615159165,0,0,1,1,0,0,3,3,1.5326394099625181e-06
545,Turkiye,TUR,Summer,1992,2814447.556,56302037.0,0.049988378857411496,2,2,2,6,6,6,6,18,6.395571294844906e-06
546,United States,USA,Summer,1992,25418990.78,256514000.0,0.09909397062148655,37,34,37,108,111,102,111,324,1.2746375448348937e-05
547,United States,USA,Summer,1992,25418990.78,256514000.0,0.09909397062148655,37,34,37,108,111,102,111,324,1.2746375448348937e-05
548,United States,USA,Winter,1992,25418990.78,256514000.0,0.09909397062148655,5,4,2,11,15,12,6,33,1.2982419438133176e-06
549,United States,USA,Winter,1992,25418990.78,256514000.0,0.09909397062148655,5,4,2,11,15,12,6,33,1.2982419438133176e-06
550,Australia,AUS,Winter,1994,18129790.720000003,17805468.0,1.018214782110754,0,0,1,1,0,0,3,3,1.654735041530584e-07
551,Austria,AUT,Winter,1994,25646700.66,7936118.0,3.231643060246836,2,3,4,9,6,9,12,27,1.052766995565659e-06
552,Belarus,BLR,Winter,1994,1460065.5,10226955.0,0.14276639527601323,0,2,0,2,0,6,0,6,4.109404680817402e-06
553,Canada,CAN,Winter,1994,19935381.46,29000663.0,0.6874112312535752,3,6,4,13,9,18,12,39,1.95632072946549e-06
554,China,CHN,Winter,1994,473492.27869999997,1191835000.0,0.00039728005864905796,0,1,2,3,0,3,6,9,1.900770171946629e-05
555,Finland,FIN,Winter,1994,20301333.09,5088333.0,3.989780757273551,0,1,5,6,0,3,15,18,8.866412821366107e-07
556,France,FRA,Winter,1994,23496367.68,59327585.0,0.3960445664525195,0,1,4,5,0,3,12,15,6.383965472572994e-07
557,United Kingdom,GBR,Winter,1994,19709238.099999998,57865745.0,0.3406028575282319,0,0,2,2,0,0,6,6,3.044257707759896e-07
558,Italy,ITA,Winter,1994,19337630.9,56843400.0,0.3401913133274927,7,5,8,20,21,15,24,60,3.102758570079027e-06
559,Japan,JPN,Winter,1994,39933515.059999995,125178000.0,0.3190138447650545,1,2,2,5,3,6,6,15,3.7562433403276776e-07
560,Kazakhstan,KAZ,Winter,1994,1316183.6290000002,16145766.0,0.08151880988489492,1,2,0,3,3,6,0,9,6.837951636610121e-06
561,"Korea, Rep.",KOR,Winter,1994,10385336.17,44641540.0,0.23263839397117572,4,1,1,6,12,3,3,18,1.7332130328141319e-06
562,Norway,NOR,Winter,1994,29315841.91,4336613.0,6.760077947928487,10,11,5,26,30,33,15,78,2.660677467134015e-06
563,Russian Federation,RUS,Winter,1994,2662104.0039999997,148407912.0,0.017937749868753627,11,8,4,23,33,24,12,69,2.5919347965489935e-05
564,Sweden,SWE,Winter,1994,26083614.39,8780745.0,2.97054684881522,2,1,0,3,6,3,0,9,3.4504420535562136e-07
565,Ukraine,UKR,Winter,1994,1011979.37,51921400.0,0.019490602526126027,1,0,1,2,3,0,3,6,5.928974619314621e-06
566,United States,USA,Winter,1994,27694853.419999998,263126000.0,0.10525319968380167,6,5,2,13,18,15,6,39,1.408203878480755e-06
567,Uzbekistan,UZB,Winter,1994,576447.1105,22377000.0,0.02576069671984627,1,0,0,1,3,0,0,3,5.204293586271694e-06
568,Argentina,ARG,Summer,1996,7690157.0030000005,35389362.0,0.21730137443562844,0,2,1,3,0,6,3,9,1.1703272113285878e-06
569,Armenia,ARM,Summer,1996,484091.641,3298898.0,0.14674344008211226,1,1,0,2,3,3,0,6,1.2394347457860772e-05
570,Australia,AUS,Summer,1996,22020093.720000003,18224767.0,1.2082510421120887,9,9,23,41,27,27,69,123,5.585807288743909e-06
571,Austria,AUT,Summer,1996,29809076.77,7959017.0,3.7453214096665453,0,1,2,3,0,3,6,9,3.0192146068266175e-07
572,Azerbaijan,AZE,Summer,1996,409163.1891,7763000.0,0.05270683873502512,0,1,0,1,0,3,0,3,7.332037876131609e-06
573,Burundi,BDI,Summer,1996,146536.1825,5930507.0,0.024708879443190945,1,0,0,1,3,0,0,3,2.0472759347337305e-05
574,Belgium,BEL,Summer,1996,27489555.18,10156637.0,2.7065607621892953,2,2,2,6,6,6,6,18,6.547941529841808e-07
575,Belarus,BLR,Summer,1996,1452507.105,10159569.0,0.1429693626767041,1,6,8,15,3,18,24,45,3.0980915580443924e-05
576,Brazil,BRA,Summer,1996,5121905.407000001,166037122.0,0.030847953429354192,3,3,9,15,9,9,27,45,8.785792868899814e-06
577,Canada,CAN,Summer,1996,21227347.529999997,29610218.0,0.7168926459778174,3,11,8,22,9,33,24,66,3.1091967522896636e-06
578,China,CHN,Summer,1996,709413.7551,1217550000.0,0.0005826567739312553,16,22,12,50,48,66,36,150,0.0002114421928270277
579,Cuba,CUB,Summer,1996,2281975.5500000003,10963031.0,0.20815188336145363,9,8,8,25,27,24,24,75,3.286625923752776e-05
580,Czechia,CZE,Summer,1996,6532837.055,10315241.0,0.6333188972511645,4,3,4,11,12,9,12,33,5.051404117716817e-06
581,Ecuador,ECU,Summer,1996,2142328.641,11775221.0,0.1819353234219553,1,0,0,1,3,0,0,3,1.4003453730608086e-06
582,Spain,ESP,Summer,1996,16109084.4,39889852.0,0.40383916190012437,5,6,6,17,15,18,18,51,3.1659155004489266e-06
583,Ethiopia,ETH,Summer,1996,144031.64870000002,59347649.0,0.00242691414279949,2,0,1,3,6,0,3,9,6.248626660343158e-05
584,Finland,FIN,Summer,1996,25783450.49,5124573.0,5.0313363650005565,1,2,1,4,3,6,3,12,4.654148212107665e-07
585,France,FRA,Summer,1996,26870285.240000002,59756533.0,0.44966272122915835,15,7,15,37,45,21,45,111,4.130957264077037e-06
586,United Kingdom,GBR,Summer,1996,24440328.14,58166950.0,0.42017551444591816,1,8,6,15,3,24,18,45,1.8412191416673835e-06
587,Georgia,GEO,Summer,1996,689059.4414,4491699.0,0.1534073056542747,0,0,2,2,0,0,6,6,8.707521644010087e-06
588,"Hong Kong SAR, China",HKG,Summer,1996,24818154.55,6435500.0,3.856445427705695,1,0,0,1,3,0,0,3,1.2087925369132653e-07
589,Hungary,HUN,Summer,1996,4525039.103,10311238.0,0.43884537462911827,7,4,10,21,21,12,30,63,1.3922531621490829e-05
590,India,IND,Summer,1996,399577.5035,983281218.0,0.0004063715406999669,0,0,1,1,0,0,3,3,7.507930185564113e-06
591,Ireland,IRL,Summer,1996,20835897.71,3637510.0,5.728066097412791,3,0,1,4,9,0,3,12,5.759291088399185e-07
592,Israel,ISR,Summer,1996,20116981.87,5692000.0,3.534255423401265,0,0,1,1,0,0,3,3,1.4912773791747717e-07
593,Italy,ITA,Summer,1996,23081604.68,56860281.0,0.405935466270383,13,10,12,35,39,30,36,105,4.549077131148578e-06
594,Jamaica,JAM,Summer,1996,2919144.486,2532894.0,1.1524937427306472,1,3,2,6,3,9,6,18,6.1661901582215826e-06
595,Japan,JPN,Summer,1996,39150039.63,125757000.0,0.311314993439729,3,6,5,14,9,18,15,42,1.0727958489169988e-06
596,Kazakhstan,KAZ,Summer,1996,1350305.67,15578227.0,0.08667903414169019,3,4,4,11,9,12,12,33,2.443891093192255e-05
597,Kenya,KEN,Summer,1996,436195.45160000003,27615736.0,0.015795177488660814,1,4,3,8,3,12,9,24,5.5021206461383465e-05
598,"Korea, Rep.",KOR,Summer,1996,13403049.59,45524681.0,0.2944128173023332,7,15,5,27,21,45,15,81,6.043400754141357e-06
599,Lithuania,LTU,Summer,1996,2327434.8570000003,3601613.0,0.6462201399761719,0,0,1,1,0,0,3,3,1.2889727035655544e-06
600,Morocco,MAR,Summer,1996,1585718.384,26999093.0,0.05873228348818977,0,0,2,2,0,0,6,6,3.7837740046028247e-06
601,Moldova,MDA,Summer,1996,575145.4551,2947293.0,0.19514363013789265,0,1,1,2,0,3,3,6,1.0432143637398273e-05
602,Mexico,MEX,Summer,1996,4487291.779,91586555.0,0.04899509299154226,0,0,1,1,0,0,3,3,6.6855469796719e-07
603,Mozambique,MOZ,Summer,1996,239857.40430000002,16079553.0,0.01491691991064677,0,0,1,1,0,0,3,3,1.2507431274657548e-05
604,Namibia,NAM,Summer,1996,2417605.515,1650066.0,1.4651568573620692,0,2,0,2,0,6,0,6,2.4817944709230196e-06
605,Norway,NOR,Summer,1996,37321974.199999996,4381336.0,8.518400369202451,2,2,3,7,6,6,9,21,5.626711997459127e-07
606,New Zealand,NZL,Summer,1996,18794436.04,3732000.0,5.036022518756699,3,2,1,6,9,6,3,18,9.57730253873582e-07
607,Poland,POL,Summer,1996,4147465.5009999997,38624370.0,0.10737949903131105,7,5,5,17,21,15,15,51,1.2296666479251808e-05
608,"Korea, Dem. People's Rep.",PRK,Summer,1996,0.0,22614347.0,0.0,2,1,2,5,6,3,6,15,0.0
609,Romania,ROU,Summer,1996,1633010.6439999999,22619004.0,0.07219639927558259,4,7,9,20,12,21,27,60,3.6741952797706326e-05
610,Russian Federation,RUS,Summer,1996,2643929.199,148160129.0,0.01784507894833164,26,21,16,63,78,63,48,189,7.148451632951613e-05
611,Slovak Republic,SVK,Summer,1996,5196940.38,5373361.0,0.9671675474623797,1,1,1,3,3,3,3,9,1.7317881949609744e-06
612,Sweden,SWE,Summer,1996,32998968.159999996,8840998.0,3.7324935669027406,2,4,2,8,6,12,6,24,7.272954682592719e-07
613,Syrian Arab Republic,SYR,Summer,1996,4184294.4399999995,14708879.0,0.2844740540730534,1,0,0,1,3,0,0,3,7.169667534199626e-07
614,Thailand,THA,Summer,1996,3039890.1,60211096.0,0.050487207540616766,1,0,1,2,3,0,3,6,1.973755564387015e-06
615,Trinidad and Tobago,TTO,Summer,1996,4385098.699999999,1313434.0,3.3386517327859635,0,0,2,2,0,0,6,6,1.3682702284443451e-06
616,Tunisia,TUN,Summer,1996,2077007.469,9430550.0,0.2202424534093982,0,0,1,1,0,0,3,3,1.4443857543971114e-06
617,Turkiye,TUR,Summer,1996,3009855.034,60293786.0,0.049919821488735173,4,1,1,6,12,3,3,18,5.9803544677959396e-06
618,Uganda,UGA,Summer,1996,284456.8035,21249572.0,0.013386472136944686,0,0,1,1,0,0,3,3,1.0546416760251615e-05
619,Ukraine,UKR,Summer,1996,872698.7305000001,51057800.0,0.017092368462800985,9,2,12,23,27,6,36,69,7.90650857948051e-05
620,United States,USA,Summer,1996,29967712.72,269394000.0,0.11124120329331759,44,32,25,101,132,96,75,303,1.0110881762350264e-05
621,Uzbekistan,UZB,Summer,1996,600598.1577999999,23225000.0,0.025859985265877284,0,1,1,2,0,3,3,6,9.990040632122634e-06
622,Australia,AUS,Winter,1998,21478385.16,18607584.0,1.154281241455097,0,0,1,1,0,0,3,3,1.3967530508704222e-07
623,Austria,AUT,Winter,1998,27361875.11,7976789.0,3.4301866465315807,3,5,9,17,9,15,27,51,1.8639073453471369e-06
624,Belgium,BEL,Winter,1998,25338443.29,10203008.0,2.4834287388581875,0,0,1,1,0,0,3,3,1.1839717087844824e-07
625,Belarus,BLR,Winter,1998,1511325.3159999999,10071963.0,0.15005270730243944,0,0,2,2,0,0,6,6,3.970025471339356e-06
626,Canada,CAN,Winter,1998,21024585.07,30155173.0,0.6972132134675533,6,5,4,15,18,15,12,45,2.140351395767165e-06
627,China,CHN,Winter,1998,828580.4793,1241935000.0,0.0006671689575541393,0,6,2,8,0,18,6,24,2.896520084600067e-05
628,Czechia,CZE,Winter,1998,6489703.619,10294373.0,0.6304127137223413,1,1,1,3,3,3,3,9,1.3868121763913175e-06
629,Finland,FIN,Winter,1998,26009269.49,5153498.0,5.046915607612537,2,4,6,12,6,12,18,36,1.3841219190658632e-06
630,France,FRA,Winter,1998,24971574.49,60192790.0,0.41485989418333985,2,1,5,8,6,3,15,24,9.6109278209954e-07
631,United Kingdom,GBR,Winter,1998,28297866.0,58487141.0,0.4838305568740315,0,0,1,1,0,0,3,3,1.0601506134773556e-07
632,Italy,ITA,Winter,1998,22318137.299999997,56906744.0,0.39218791537256104,2,6,2,10,6,18,6,30,1.3441982006267165e-06
633,Japan,JPN,Winter,1998,32423755.61,126400000.0,0.25651705387658225,5,1,4,10,15,3,12,30,9.252475364312062e-07
634,Kazakhstan,KAZ,Winter,1998,1468669.291,15071640.0,0.09744588452218869,0,0,2,2,0,0,6,6,4.08533087521335e-06
635,"Korea, Rep.",KOR,Winter,1998,8281699.982,46286503.0,0.17892256803241324,3,1,2,6,9,3,6,18,2.1734668050185837e-06
636,Norway,NOR,Winter,1998,34788359.85,4431464.0,7.8503085774813925,10,10,5,25,30,30,15,75,2.155893532301725e-06
637,Russian Federation,RUS,Winter,1998,1834861.816,147670784.0,0.012425354334138296,9,6,3,18,27,18,9,54,2.9430009131543233e-05
638,Sweden,SWE,Winter,1998,30596527.2,8850974.0,3.4568542625930205,0,2,1,3,0,6,3,9,2.941510303169309e-07
639,Ukraine,UKR,Winter,1998,835250.9765999999,50144500.0,0.016656881145489535,0,1,0,1,0,3,0,3,3.591734800732468e-06
640,United States,USA,Winter,1998,32853676.95,275854000.0,0.11909806256207994,6,3,4,13,18,9,12,39,1.187081740024232e-06
641,Argentina,ARG,Summer,2000,7666517.834,37070774.0,0.20680760088796635,0,2,2,4,0,6,6,12,1.5652477773913962e-06
642,Armenia,ARM,Summer,2000,603298.0252,3168523.0,0.19040354928779119,0,0,1,1,0,0,3,3,4.972666699854465e-06
643,Australia,AUS,Summer,2000,21853781.67,19028802.0,1.1484580936834594,16,25,17,58,48,75,51,174,7.962008709863715e-06
644,Austria,AUT,Summer,2000,24625600.72,8011566.0,3.073756206963782,2,1,0,3,6,3,0,9,3.65473317882984e-07
645,Azerbaijan,AZE,Summer,2000,655119.9452,8048600.0,0.08139551539398156,2,0,1,3,6,0,3,9,1.3737942289716751e-05
646,Belgium,BEL,Summer,2000,23098886.51,10251250.0,2.253275113766614,0,2,3,5,0,6,9,15,6.493819515285371e-07
647,Belarus,BLR,Summer,2000,1276288.034,9979610.0,0.12788957023370653,3,3,11,17,9,9,33,51,3.995963187099817e-05
648,Brazil,BRA,Summer,2000,3726811.42,175873720.0,0.02119026890430247,0,6,6,12,0,18,18,36,9.659732125646432e-06
649,Canada,CAN,Summer,2000,24271002.06,30685730.0,0.7909540382451387,3,3,8,14,9,9,24,42,1.7304600731429382e-06
650,Channel Islands,CHI,Summer,2000,44316153.59,145306.0,304.9850218848499,0,0,1,1,0,0,3,3,6.769540578262085e-08
651,China,CHN,Summer,2000,959372.4836,1262645000.0,0.000759811731405106,28,16,14,58,84,48,42,174,0.00018136855389793254
652,Cameroon,CMR,Summer,2000,700163.2135999999,15091594.0,0.04639425189943487,1,0,0,1,3,0,0,3,4.2847152517125624e-06
653,Colombia,COL,Summer,2000,2547143.528,39215135.0,0.06495307304182428,1,0,0,1,3,0,0,3,1.1777899309645813e-06
654,Cuba,CUB,Summer,2000,2752203.783,11105791.0,0.2478169977266815,11,11,7,29,33,33,21,87,3.161103132601864e-05
655,Czechia,CZE,Summer,2000,6029038.193,10255063.0,0.5879084500017211,2,3,3,8,6,9,9,24,3.980734444154814e-06
656,Spain,ESP,Summer,2000,14749687.42,40567864.0,0.36358057747383493,3,3,5,11,9,9,15,33,2.237335548904805e-06
657,Estonia,EST,Summer,2000,4070609.0239999997,1396985.0,2.9138530649935395,1,0,2,3,3,0,6,9,2.2109713674137427e-06
658,Ethiopia,ETH,Summer,2000,122962.2935,67031867.0,0.0018343856288532139,4,1,3,8,12,3,9,24,0.00019518178554468814
659,Finland,FIN,Summer,2000,24345914.82,5176209.0,4.703425773572898,2,1,1,4,6,3,3,12,4.928958344231979e-07
660,France,FRA,Summer,2000,22416425.419999998,60921384.0,0.36795660157687815,13,14,11,38,39,42,33,114,5.085556589155775e-06
661,United Kingdom,GBR,Summer,2000,28290972.5,58892514.0,0.4803831689032667,11,10,7,28,33,30,21,84,2.9691450161354472e-06
662,Georgia,GEO,Summer,2000,749908.535,4077131.0,0.18393044888672944,0,0,6,6,0,0,18,18,2.4002927236986307e-05
663,Hungary,HUN,Summer,2000,4624281.657000001,10210971.0,0.4528738409892654,8,6,3,17,24,18,9,51,1.1028739982305969e-05
664,India,IND,Summer,2000,442034.7789,1059633675.0,0.00041715810787157175,0,0,1,1,0,0,3,3,6.78679629567944e-06
665,Ireland,IRL,Summer,2000,26334567.21,3805174.0,6.9207261507620945,0,1,0,1,0,3,0,3,1.1391871284905008e-07
666,Iceland,ISL,Summer,2000,32096372.26,281205.0,114.13869689372522,0,0,1,1,0,0,3,3,9.34685071477296e-08
667,Israel,ISR,Summer,2000,21630747.61,6289000.0,3.4394574034027667,0,0,1,1,0,0,3,3,1.3869146152919308e-07
668,Italy,ITA,Summer,2000,20137591.22,56942108.0,0.35365025861002547,13,8,13,34,39,24,39,102,5.065153964328014e-06
669,Jamaica,JAM,Summer,2000,3447303.8959999997,2612205.0,1.3196911789082402,0,6,3,9,0,18,9,27,7.832207665627865e-06
670,Japan,JPN,Summer,2000,39169359.57,126843000.0,0.3088019013268371,5,8,5,18,15,24,15,54,1.3786286166741123e-06
671,Kazakhstan,KAZ,Summer,2000,1229001.247,14883626.0,0.08257404795041208,3,4,0,7,9,12,0,21,1.708704531525996e-05
672,Kenya,KEN,Summer,2000,411821.5792,30851606.0,0.013348464880564077,2,3,2,7,6,9,6,21,5.09929568061838e-05
673,Kyrgyz Republic,KGZ,Summer,2000,279619.56930000003,4898400.0,0.057083857851543365,0,0,1,1,0,0,3,3,1.0728862817113278e-05
674,"Korea, Rep.",KOR,Summer,2000,12256993.57,47008111.0,0.26074209980486135,8,10,10,28,24,30,30,84,6.853230322776452e-06
675,Lithuania,LTU,Summer,2000,3293229.9790000003,3499536.0,0.9410476071684932,2,0,3,5,6,0,9,15,4.554798813217046e-06
676,Morocco,MAR,Summer,2000,1348049.8050000002,28554415.0,0.04720985546368224,0,1,4,5,0,3,12,15,1.1127185319388106e-05
677,Moldova,MDA,Summer,2000,440538.684,2924668.0,0.1506286128887108,0,1,1,2,0,3,3,6,1.3619689298386337e-05
678,Mexico,MEX,Summer,2000,7232878.808999999,97873442.0,0.07390032128429691,1,2,3,6,3,6,9,18,2.488635642228967e-06
679,North Macedonia,MKD,Summer,2000,1861898.0650000002,2026350.0,0.9188432723863105,0,0,1,1,0,0,3,3,1.6112589923122348e-06
680,Mozambique,MOZ,Summer,2000,318342.6885,17768505.0,0.01791612116494888,1,0,0,1,3,0,0,3,9.423806823193302e-06
681,Norway,NOR,Summer,2000,38131460.61,4490967.0,8.490701581641549,4,3,3,10,12,9,9,30,7.867519240039938e-07
682,New Zealand,NZL,Summer,2000,13641102.72,3857700.0,3.5360714207947743,1,0,3,4,3,0,9,12,8.796942773846365e-07
683,Poland,POL,Summer,2000,4501454.067,38258629.0,0.11765853049778652,6,5,3,14,18,15,9,42,9.330318464849061e-06
684,"Korea, Dem. People's Rep.",PRK,Summer,2000,0.0,23367059.0,0.0,0,1,3,4,0,3,9,12,0.0
685,Qatar,QAT,Summer,2000,27494771.33,645937.0,42.565716672059345,0,0,1,1,0,0,3,3,1.0911165486678008e-07
686,Romania,ROU,Summer,2000,1659907.64,22442971.0,0.07396113642886229,11,6,9,26,33,18,27,78,4.699056629439937e-05
687,Russian Federation,RUS,Summer,2000,1771594.116,146596869.0,0.01208480186572061,32,28,29,89,96,84,87,267,0.00015071172205225364
688,Slovak Republic,SVK,Summer,2000,5426624.281,5388720.0,1.0070340045502457,1,3,1,5,3,9,3,15,2.7641493538660557e-06
689,Sweden,SWE,Summer,2000,29624912.67,8872109.0,3.3391060310462826,4,5,3,12,12,15,9,36,1.2151934556234422e-06
690,Thailand,THA,Summer,2000,2004107.209,63066603.0,0.03177763053132892,1,0,2,3,3,0,6,9,4.490777718668443e-06
691,Trinidad and Tobago,TTO,Summer,2000,6120942.704,1332203.0,4.594602101931913,0,1,1,2,0,3,3,6,9.80241163845405e-07
692,Turkiye,TUR,Summer,2000,4278393.130000001,64113547.0,0.06673149950664874,3,0,2,5,9,0,6,15,3.505989174959244e-06
693,Ukraine,UKR,Summer,2000,658348.6328,49176500.0,0.013387464191229551,3,10,10,23,9,30,30,69,0.00010480769088338266
694,United States,USA,Summer,2000,36329956.07,282162411.0,0.1287554778868118,37,24,32,93,111,72,96,279,7.679612919498914e-06
695,Uzbekistan,UZB,Summer,2000,558226.8024,24650400.0,0.022645750267744135,1,1,2,4,3,3,6,12,2.1496638908071176e-05
696,Australia,AUS,Winter,2002,20291178.55,19495210.0,1.0408289292600592,2,0,0,2,6,0,0,6,2.9569499796255055e-07
697,Austria,AUT,Winter,2002,26527593.09,8081957.0,3.282322968310769,3,3,10,16,9,9,30,48,1.8094366811625426e-06
698,Belarus,BLR,Winter,2002,1479314.583,9865548.0,0.14994753286892934,0,0,1,1,0,0,3,3,2.0279662179197216e-06
699,Canada,CAN,Winter,2002,24255338.58,31360079.0,0.7734463481421714,7,3,7,17,21,9,21,51,2.1026298945194936e-06
700,China,CHN,Winter,2002,1148508.29,1280400000.0,0.0008969917916276164,2,2,4,8,6,6,12,24,2.0896671107180253e-05
701,Czechia,CZE,Winter,2002,8060868.703,10196916.0,0.7905202615182865,1,2,0,3,3,6,0,9,1.1165049737940137e-06
702,Estonia,EST,Winter,2002,5341628.947,1379350.0,3.8725696501975566,1,1,1,3,3,3,3,9,1.6848792923092568e-06
703,Finland,FIN,Winter,2002,26997752.990000002,5200598.0,5.191278577963534,4,2,1,7,12,6,3,21,7.778425118482424e-07
704,France,FRA,Winter,2002,24288270.02,61816234.0,0.3929108657767796,4,5,2,11,12,15,6,33,1.3586805471458606e-06
705,United Kingdom,GBR,Winter,2002,30079660.04,59370479.0,0.5066433781004193,1,0,0,1,3,0,0,3,9.97351697462868e-08
706,Italy,ITA,Winter,2002,22376297.900000002,57059007.0,0.39216066098030766,4,4,5,13,12,12,15,39,1.7429156589839642e-06
707,Japan,JPN,Winter,2002,32820793.640000004,127445000.0,0.257529080309153,0,1,1,2,0,3,3,6,1.8281093582964313e-07
708,"Korea, Rep.",KOR,Winter,2002,13165065.74,47644736.0,0.2763173195040896,2,2,0,4,6,6,0,12,9.115032341646325e-07
709,Norway,NOR,Winter,2002,43084472.47,4538159.0,9.493821717132432,13,5,7,25,39,15,21,75,1.7407663527091574e-06
710,Poland,POL,Winter,2002,5207171.421,38230364.0,0.13620512273961086,0,1,1,2,0,3,3,6,1.152257053762932e-06
711,Russian Federation,RUS,Winter,2002,2377529.5409999997,145306497.0,0.01636216955254244,5,4,4,13,15,12,12,39,1.6403581670575762e-05
712,Sweden,SWE,Winter,2002,29899195.25,8924958.0,3.3500656529700197,0,2,5,7,0,6,15,21,7.023600409445803e-07
713,United States,USA,Winter,2002,37997759.660000004,287625193.0,0.1321085933525997,8,12,11,31,24,36,33,93,2.4475127173852964e-06
714,Argentina,ARG,Summer,2004,4258160.261,38668796.0,0.11011877020944744,2,0,4,6,6,0,12,18,4.227177676908953e-06
715,Australia,AUS,Summer,2004,30819993.490000002,19932722.0,1.546200939841533,17,16,17,50,51,48,51,150,4.8669705283574995e-06
716,Austria,AUT,Summer,2004,36889233.51,8171966.0,4.514119798099991,2,4,1,7,6,12,3,21,5.692717902177957e-07
717,Azerbaijan,AZE,Summer,2004,1045009.3790000001,8306500.0,0.12580622151327275,1,0,4,5,3,0,12,15,1.4353938157333992e-05
718,Belgium,BEL,Summer,2004,35429407.79,10421137.0,3.399764132263111,1,0,2,3,3,0,6,9,2.5402626127271205e-07
719,Belarus,BLR,Summer,2004,2378623.286,9730146.0,0.24445915672796686,2,5,6,13,6,15,18,39,1.639603893123579e-05
720,Brazil,BRA,Summer,2004,3623247.9960000003,184722043.0,0.019614594648024765,5,2,3,10,15,6,9,30,8.279863821940825e-06
721,Canada,CAN,Summer,2004,32143681.41,31940655.0,1.0063563633870376,3,6,3,12,9,18,9,36,1.1199712796058352e-06
722,Channel Islands,CHI,Summer,2004,57202561.029999994,149538.0,382.52859493907897,2,0,1,3,6,0,3,9,1.5733561291565132e-07
723,China,CHN,Summer,2004,1508668.098,1296075000.0,0.0011640283918754701,32,17,14,63,96,51,42,189,0.00012527606320472483
724,Cameroon,CMR,Summer,2004,1119980.93,16809407.0,0.06662822370830809,1,0,0,1,3,0,0,3,2.678617036809725e-06
725,Colombia,COL,Summer,2004,2811197.871,41648268.0,0.06749855410553927,0,0,2,2,0,0,6,6,2.134321479784587e-06
726,Cuba,CUB,Summer,2004,3403296.163,11225294.0,0.30318102697354743,9,7,11,27,27,21,33,81,2.3800455828856996e-05
727,Czechia,CZE,Summer,2004,11749852.66,10197101.0,1.1522738335140545,1,3,5,9,3,9,15,27,2.297901155128187e-06
728,Dominican Republic,DOM,Summer,2004,2468437.673,9043127.0,0.27296284493184714,1,0,0,1,3,0,0,3,1.2153436292170865e-06
729,"Egypt, Arab Rep.",EGY,Summer,2004,1016253.884,77522427.0,0.013109159804813643,1,1,3,5,3,3,9,15,1.4760091189968826e-05
730,Eritrea,ERI,Summer,2004,401374.5252,2763140.0,0.14526029271046706,0,0,1,1,0,0,3,3,7.474315911068688e-06
731,Spain,ESP,Summer,2004,24907000.85,42921895.0,0.5802866078023815,3,11,6,20,9,33,18,60,2.4089612539600484e-06
732,Estonia,EST,Summer,2004,8914103.557,1362550.0,6.542221244724964,0,1,2,3,0,3,6,9,1.0096360158316253e-06
733,Ethiopia,ETH,Summer,2004,134542.48630000002,75301026.0,0.0017867284610438112,2,3,2,7,6,9,6,21,0.00015608452450607046
734,Finland,FIN,Summer,2004,37772178.11,5228172.0,7.224738992902299,0,2,0,2,0,6,0,6,1.5884707475769127e-07
735,France,FRA,Summer,2004,33797162.44,62716306.0,0.5388895583231575,11,9,13,33,33,27,39,99,2.9292399968711697e-06
736,United Kingdom,GBR,Summer,2004,40390785.83,59987905.0,0.6733154930148002,9,9,12,30,27,27,36,90,2.2282309727470833e-06
737,Georgia,GEO,Summer,2004,1305047.486,3927340.0,0.3322980658664643,2,2,0,4,6,6,0,12,9.195067711122353e-06
738,"Hong Kong SAR, China",HKG,Summer,2004,24928100.37,6783500.0,3.6748139411808065,0,1,0,1,0,3,0,3,1.2034611364171107e-07
739,Hungary,HUN,Summer,2004,10301703.39,10107146.0,1.0192494884312546,8,6,3,17,24,18,9,51,4.950637585771143e-06
740,India,IND,Summer,2004,624105.0944,1136264583.0,0.000549260360427867,0,1,0,1,0,3,0,3,4.8068827300378475e-06
741,Israel,ISR,Summer,2004,20557078.63,6809000.0,3.0191039256865912,1,0,1,2,3,0,3,6,2.9187026561468184e-07
742,Italy,ITA,Summer,2004,31317200.79,57685327.0,0.5428971701937305,10,11,11,32,30,33,33,96,3.0654080689949172e-06
743,Jamaica,JAM,Summer,2004,3819284.231,2664024.0,1.4336523360900653,2,1,2,5,6,3,6,15,3.927437470678259e-06
744,Japan,JPN,Summer,2004,38298980.17,127761000.0,0.2997705103278778,16,9,12,37,48,27,36,111,2.898249496652328e-06
745,Kazakhstan,KAZ,Summer,2004,2874288.483,15012984.0,0.1914535100417079,1,4,3,8,3,12,9,24,8.349892553217317e-06
746,Kenya,KEN,Summer,2004,462618.21579999995,34791836.0,0.013296746276913927,1,4,2,7,3,12,6,21,4.539380267092371e-05
747,"Korea, Rep.",KOR,Summer,2004,16496120.09,48082519.0,0.34307936508068554,9,12,9,30,27,36,27,90,5.45582837109426e-06
748,Lithuania,LTU,Summer,2004,6700327.192,3377075.0,1.9840623000673658,1,2,0,3,3,6,0,9,1.3432179865403803e-06
749,Morocco,MAR,Summer,2004,1964080.078,30033125.0,0.06539712660603916,2,1,0,3,6,3,0,9,4.58229789142029e-06
750,Mexico,MEX,Summer,2004,7525465.234,103945813.0,0.07239796406229465,0,3,1,4,0,9,3,12,1.5945857999295621e-06
751,Norway,NOR,Summer,2004,57603836.02,4591910.0,12.544635243286564,5,0,1,6,15,0,3,18,3.124791896454676e-07
752,New Zealand,NZL,Summer,2004,25420234.88,4087500.0,6.21901770764526,3,2,0,5,9,6,0,15,5.900810936960154e-07
753,Poland,POL,Summer,2004,6681386.472,38182222.0,0.17498684262010733,3,2,5,10,9,6,15,30,4.4900860211757555e-06
754,"Korea, Dem. People's Rep.",PRK,Summer,2004,0.0,23948930.0,0.0,0,4,1,5,0,12,3,15,0.0
755,Romania,ROU,Summer,2004,3494944.517,21451748.0,0.16292119956844542,8,5,6,19,24,15,18,57,1.6309271784642754e-05
756,Russian Federation,RUS,Summer,2004,4102364.7460000003,144067316.0,0.028475332642415578,28,26,36,90,84,78,108,270,6.581569819291733e-05
757,Slovak Republic,SVK,Summer,2004,10691446.55,5372280.0,1.9901134248401053,2,2,2,6,6,6,6,18,1.683588831110978e-06
758,Sweden,SWE,Summer,2004,42821673.14,8993531.0,4.761386060714084,4,2,1,7,12,6,3,21,4.904058730106874e-07
759,Syrian Arab Republic,SYR,Summer,2004,6241058.232000001,18084007.0,0.3451147874472732,0,0,1,1,0,0,3,3,4.806877116797265e-07
760,Thailand,THA,Summer,2004,2647261.7199999997,65311166.0,0.040533064744242966,3,1,4,8,9,3,12,24,9.065971761945775e-06
761,Trinidad and Tobago,TTO,Summer,2004,9756500.371,1361172.0,7.167720443118136,0,0,1,1,0,0,3,3,3.074873044557178e-07
762,Turkiye,TUR,Summer,2004,6031947.927,67785075.0,0.08898637239834875,3,3,4,10,9,9,12,30,4.973517736404026e-06
763,Ukraine,UKR,Summer,2004,1416603.76,47451626.0,0.02985363999960718,8,5,9,22,24,15,27,66,4.6590304122869194e-05
764,United States,USA,Summer,2004,41724631.63,292805298.0,0.14249957878152875,36,39,26,101,108,117,78,303,7.261897545001765e-06
765,Uzbekistan,UZB,Summer,2004,465119.8869,25864350.0,0.017983049521832172,2,1,2,5,6,3,6,15,3.224974984401167e-05
766,"Venezuela, RB",VEN,Summer,2004,4287707.147,26226927.0,0.16348492322413524,0,0,2,2,0,0,6,6,1.3993493012222275e-06
767,Australia,AUS,Winter,2006,36570720.370000005,20450966.0,1.7882148144004544,1,0,1,2,3,0,3,6,1.640656771126108e-07
768,Austria,AUT,Winter,2006,40669326.96,8268641.0,4.918501959390908,9,7,7,23,27,21,21,69,1.6966103242343894e-06
769,Belarus,BLR,Winter,2006,3847434.124,9604924.0,0.40056892943660977,0,1,0,1,0,3,0,3,7.797404460511044e-07
770,Canada,CAN,Winter,2006,40504060.73,32571174.0,1.243555443534212,6,9,6,21,18,27,18,63,1.555399603510322e-06
771,China,CHN,Winter,2006,2099229.435,1311020000.0,0.00160121846730027,2,4,5,11,6,12,15,33,1.5720053963515428e-05
772,Czechia,CZE,Winter,2006,15261797.59,10238905.0,1.490569312831792,1,2,1,4,3,6,3,12,7.862769722396771e-07
773,Estonia,EST,Winter,2006,12639400.07,1346810.0,9.38469425531441,3,0,0,3,9,0,0,9,7.120591127866719e-07
774,Finland,FIN,Winter,2006,41222602.0,5266268.0,7.827668853920841,0,6,3,9,0,18,9,27,6.549804886164148e-07
775,France,FRA,Winter,2006,36470212.84,63628261.0,0.5731763255324549,3,2,4,9,9,6,12,27,7.403302009355643e-07
776,Italy,ITA,Winter,2006,33529726.6,58143979.0,0.5766672177698744,5,0,6,11,15,0,18,33,9.842012848383918e-07
777,Japan,JPN,Winter,2006,35991546.0,127854000.0,0.2815050448167441,1,0,0,1,3,0,0,3,8.33529073744151e-08
778,"Korea, Rep.",KOR,Winter,2006,21743477.45,48438292.0,0.44889025917759445,6,3,2,11,18,9,6,33,1.5176965173066188e-06
779,Norway,NOR,Winter,2006,74148320.08,4660677.0,15.909345376218948,2,8,9,19,6,24,27,57,7.68729486231133e-07
780,Poland,POL,Winter,2006,9035410.467,38141267.0,0.23689329636060596,0,1,1,2,0,3,3,6,6.640539488398208e-07
781,Russian Federation,RUS,Winter,2006,6920188.965,143049637.0,0.04837613789261136,8,6,8,22,24,18,24,66,9.537311818189635e-06
782,Slovak Republic,SVK,Winter,2006,13170784.98,5373054.0,2.4512660732611287,0,1,0,1,0,3,0,3,2.2777685647101043e-07
783,Sweden,SWE,Winter,2006,46593602.160000004,9080505.0,5.131168603508286,7,2,5,14,21,6,15,42,9.014113108442267e-07
784,Ukraine,UKR,Winter,2006,2391323.9749999996,46787786.0,0.05111000497010052,0,0,2,2,0,0,6,6,2.5090703153260533e-06
785,United States,USA,Winter,2006,46302000.88,298379912.0,0.15517800970462114,9,9,7,25,27,27,21,75,1.6198004098003462e-06
786,Afghanistan,AFG,Summer,2008,387849.1743,26427199.0,0.014676136290493745,0,0,1,1,0,0,3,3,7.734965545342402e-06
787,Argentina,ARG,Summer,2008,8977506.851,40273769.0,0.22291201131436195,2,0,4,6,6,0,12,18,2.0050110012441804e-06
788,Armenia,ARM,Summer,2008,3908949.06,2983421.0,1.3102237532014422,0,1,4,5,0,3,12,15,3.837348548103106e-06
789,Australia,AUS,Summer,2008,49679180.53,21249199.0,2.3379319159277485,14,15,17,46,42,45,51,138,2.777823597888562e-06
790,Austria,AUT,Summer,2008,51919983.58,8321496.0,6.23926077474531,0,1,2,3,0,3,6,9,1.7334366036792957e-07
791,Azerbaijan,AZE,Summer,2008,5574603.801999999,8763400.0,0.6361233998219868,1,1,4,6,3,3,12,18,3.228929021564213e-06
792,Belgium,BEL,Summer,2008,48303397.96,10709973.0,4.510132561491985,2,0,0,2,6,0,0,6,1.242148638273563e-07
793,Belarus,BLR,Summer,2008,6377369.732,9527985.0,0.6693303706922292,3,4,7,14,9,12,21,42,6.585787207734689e-06
794,Brazil,BRA,Summer,2008,8801599.484000001,192672317.0,0.045681702597680396,3,4,10,17,9,12,30,51,5.794401357697588e-06
795,Canada,CAN,Summer,2008,46710505.58,33247118.0,1.4049490118211148,3,9,8,20,9,27,24,60,1.2845076124735878e-06
796,Channel Islands,CHI,Summer,2008,0.0,154475.0,0.0,0,1,0,1,0,3,0,3,0.0
797,China,CHN,Summer,2008,3468304.602,1324655000.0,0.002618270117124836,48,22,30,100,144,66,90,300,8.649759303926328e-05
798,Cameroon,CMR,Summer,2008,1476009.215,18777081.0,0.07860695786528268,1,0,0,1,3,0,0,3,2.032507635800905e-06
799,Colombia,COL,Summer,2008,5527449.953000001,43815313.0,0.12615338279108038,0,2,1,3,0,6,3,9,1.6282372661041078e-06
800,Cuba,CUB,Summer,2008,4992824.494000001,11276609.0,0.44275938750736155,3,10,17,30,9,30,51,90,1.802586894615567e-05
801,Czechia,CZE,Summer,2008,22804577.68,10384603.0,2.195998988117312,3,3,1,7,9,9,3,21,9.208677439537657e-07
802,Dominican Republic,DOM,Summer,2008,5053324.5770000005,9522948.0,0.530647082920121,1,1,0,2,3,3,0,6,1.1873371497466744e-06
803,Ecuador,ECU,Summer,2008,4260433.184,14496797.0,0.29388789702994395,0,1,0,1,0,3,0,3,7.041537492634457e-07
804,"Egypt, Arab Rep.",EGY,Summer,2008,1941899.973,83844783.0,0.023160653573401222,0,0,2,2,0,0,6,6,3.0897574969995637e-06
805,Spain,ESP,Summer,2008,35510722.23,45954106.0,0.7727431849071331,5,11,3,19,15,33,9,57,1.6051489922062338e-06
806,Estonia,EST,Summer,2008,18204966.48,1337090.0,13.615363573132699,1,1,0,2,3,3,0,6,3.2958039261382917e-07
807,Ethiopia,ETH,Summer,2008,320861.08969999995,84357105.0,0.0038036048024644746,4,2,1,7,12,6,3,21,6.544888325235904e-05
808,Finland,FIN,Summer,2008,53772794.24,5313399.0,10.120225159074257,1,1,2,4,3,3,6,12,2.2316117601107575e-07
809,France,FRA,Summer,2008,45515961.75,64379696.0,0.7069924926330811,7,16,20,43,21,48,60,129,2.8341705863218413e-06
810,United Kingdom,GBR,Summer,2008,47429936.34,61806995.0,0.7673878391919879,19,13,19,51,57,39,57,153,3.225810781258999e-06
811,Georgia,GEO,Summer,2008,3324735.8789999997,3848449.0,0.863915795428236,3,2,2,7,9,6,6,21,6.316291207563921e-06
812,Hungary,HUN,Summer,2008,15772330.08,10038188.0,1.5712327842435307,3,5,2,10,9,15,6,30,1.9020651893432857e-06
813,India,IND,Summer,2008,993503.7725,1206734806.0,0.0008232991768864252,1,0,2,3,3,0,6,9,9.058848339702706e-06
814,Ireland,IRL,Summer,2008,61353106.56,4489544.0,13.665776871771387,0,1,2,3,0,3,6,9,1.4669183851674224e-07
815,Iceland,ISL,Summer,2008,56943370.45,317414.0,179.39779105521495,0,1,0,1,0,3,0,3,5.2683920468567904e-08
816,Israel,ISR,Summer,2008,30173361.59,7308800.0,4.128360550295534,0,0,1,1,0,0,3,3,9.942544820707861e-08
817,Italy,ITA,Summer,2008,40944912.42,58826731.0,0.6960256285531148,8,9,10,27,24,27,30,81,1.9782677556890962e-06
818,Jamaica,JAM,Summer,2008,5056258.245,2711373.0,1.8648331472652417,5,4,2,11,15,12,6,33,6.526565377200191e-06
819,Japan,JPN,Summer,2008,39876303.97,128063000.0,0.3113803672411235,9,8,8,25,27,24,24,75,1.880816237543592e-06
820,Kazakhstan,KAZ,Summer,2008,8458017.154,15776938.0,0.5361000438741661,2,3,4,9,6,9,12,27,3.1922375550197427e-06
821,Kenya,KEN,Summer,2008,915998.9157,39186895.0,0.023375133847680456,6,4,6,16,18,12,18,48,5.2401808754673836e-05
822,Kyrgyz Republic,KGZ,Summer,2008,966393.6272,5318700.0,0.18169733716885705,0,1,2,3,0,3,6,9,9.31297532049785e-06
823,"Korea, Rep.",KOR,Summer,2008,21350427.98,49054708.0,0.43523708223887503,13,11,8,32,39,33,24,96,4.4963969851062444e-06
824,Lithuania,LTU,Summer,2008,14944996.649999999,3198231.0,4.6728946877195545,0,3,2,5,0,9,6,15,1.0036803855690394e-06
825,Morocco,MAR,Summer,2008,2889220.9469999997,31634992.0,0.09132990920307486,0,1,1,2,0,3,3,6,2.076684376191462e-06
826,Moldova,MDA,Summer,2008,2110561.99,2868833.0,0.7356865979999534,0,0,1,1,0,0,3,3,1.4214223577484211e-06
827,Mexico,MEX,Summer,2008,10119836.209999999,109684489.0,0.09226314770906212,2,0,2,4,6,0,6,12,1.1857899427405853e-06
828,Norway,NOR,Summer,2008,96944095.61,4768212.0,20.331330823797263,3,5,1,9,9,15,3,27,2.7851103081738267e-07
829,New Zealand,NZL,Summer,2008,31252962.56,4259800.0,7.336720634771585,3,2,4,9,9,6,12,27,8.639180989055011e-07
830,Panama,PAN,Summer,2008,7197110.786,3495276.0,2.059096559470554,1,0,0,1,3,0,0,3,4.1683393367178324e-07
831,Poland,POL,Summer,2008,13996025.15,38125759.0,0.36710154806360706,4,5,2,11,12,15,6,33,2.3578122821535514e-06
832,"Korea, Dem. People's Rep.",PRK,Summer,2008,0.0,24469047.0,0.0,2,2,2,6,6,6,6,18,0.0
833,Romania,ROU,Summer,2008,10435043.98,20537875.0,0.5080878123953915,4,1,4,9,12,3,12,27,2.5874351897077486e-06
834,Russian Federation,RUS,Summer,2008,11635272.46,142742366.0,0.0815123973775242,24,13,23,60,72,39,69,180,1.5470200686645544e-05
835,Singapore,SGP,Summer,2008,40007469.26,4839396.0,8.26703771710354,0,1,0,1,0,3,0,3,7.498599775216074e-08
836,Serbia,SRB,Summer,2008,7101040.141000001,7350222.0,0.9660987302152235,0,1,2,3,0,3,6,9,1.267419958385502e-06
837,Slovak Republic,SVK,Summer,2008,18753584.94,5379233.0,3.4862934808735746,3,3,0,6,9,9,0,18,9.598164861592591e-07
838,Sweden,SWE,Summer,2008,56152552.34,9219637.0,6.090538308612367,0,4,1,5,0,12,3,15,2.6712944247264113e-07
839,Thailand,THA,Summer,2008,4327797.6,67328239.0,0.06427908503592378,2,2,2,6,6,6,6,18,4.159159383978585e-06
840,Tajikistan,TJK,Summer,2008,704655.3136999999,7324627.0,0.09620357646880857,0,1,1,2,0,3,3,6,8.514801326758236e-06
841,Trinidad and Tobago,TTO,Summer,2008,20011148.270000003,1392803.0,14.367536737069063,1,1,0,2,3,3,0,6,2.9983286911101376e-07
842,Tunisia,TUN,Summer,2008,4200315.819999999,10680380.0,0.3932740052320235,1,0,0,1,3,0,0,3,7.142320074398597e-07
843,Turkiye,TUR,Summer,2008,10802780.61,71320726.0,0.15146761980521622,1,1,3,5,3,3,9,15,1.3885313921968097e-06
844,Ukraine,UKR,Summer,2008,4066547.852,46258189.0,0.08790979370160816,7,4,11,22,21,12,33,66,1.6229982383593503e-05
845,United States,USA,Summer,2008,48570045.980000004,304093966.0,0.1597205186899368,36,39,37,112,108,117,111,336,6.917843976066171e-06
846,Uzbekistan,UZB,Summer,2008,1082286.0250000001,27302800.0,0.039640111087507514,0,1,3,4,0,3,9,12,1.1087642012193587e-05
847,"Venezuela, RB",VEN,Summer,2008,11310778.17,27933833.0,0.4049132165285015,0,0,1,1,0,0,3,3,2.652337403236333e-07
848,Australia,AUS,Winter,2010,52134308.85,22031750.0,2.3663262723115506,2,1,0,3,6,3,0,9,1.7263104083521384e-07
849,Austria,AUT,Winter,2010,46903761.59,8363404.0,5.608214261800578,4,6,6,16,12,18,18,48,1.0233720787595363e-06
850,Belarus,BLR,Winter,2010,6033686.239,9483836.0,0.636207357339372,1,1,1,3,3,3,3,9,1.491625458053587e-06
851,Canada,CAN,Winter,2010,47562083.43,34004889.0,1.3986836842784578,14,7,5,26,42,21,15,78,1.6399618009752942e-06
852,China,CHN,Winter,2010,4550453.108,1337705000.0,0.003401686551220187,5,2,4,11,15,6,12,33,7.252025065808018e-06
853,Czechia,CZE,Winter,2010,19960068.490000002,10474410.0,1.905603130868469,2,0,4,6,6,0,12,18,9.018005128097633e-07
854,Estonia,EST,Winter,2010,14663044.610000001,1331475.0,11.012632313787343,0,1,0,1,0,3,0,3,2.045959812434888e-07
855,Finland,FIN,Winter,2010,46505303.18,5363352.0,8.670939960681306,0,1,4,5,0,3,12,15,3.225438600398347e-07
856,France,FRA,Winter,2010,40676064.79,65030575.0,0.6254913906266398,2,3,6,11,6,9,18,33,8.112879200672549e-07
857,United Kingdom,GBR,Winter,2010,39693193.870000005,62766365.0,0.632395931642688,1,0,0,1,3,0,0,3,7.557970794250929e-08
858,Italy,ITA,Winter,2010,36035645.0,59277417.0,0.607915236927412,1,1,3,5,3,3,9,15,4.162545168818263e-07
859,Japan,JPN,Winter,2010,44968156.230000004,128070000.0,0.35112170086671357,0,3,2,5,0,9,6,15,3.33569380147121e-07
860,Kazakhstan,KAZ,Winter,2010,9070488.252999999,16321872.0,0.5557259763463406,0,1,0,1,0,3,0,3,3.3074294528828385e-07
861,"Korea, Rep.",KOR,Winter,2010,23087225.64,49554112.0,0.4658992908600602,6,6,2,14,18,18,6,42,1.8191878337790612e-06
862,Norway,NOR,Winter,2010,87693790.07000001,4889252.0,17.936033992520738,9,8,6,23,27,24,18,69,7.868288044674769e-07
863,Poland,POL,Winter,2010,12504250.190000001,38042794.0,0.3286890597467684,1,3,2,6,3,9,6,18,1.4395105445342979e-06
864,Russian Federation,RUS,Winter,2010,10674996.09,142849468.0,0.07472898737011748,3,5,7,15,9,15,21,45,4.2154582184957036e-06
865,Slovak Republic,SVK,Winter,2010,16908847.96,5391428.0,3.1362466418915362,1,1,1,3,3,3,3,9,5.322657120869871e-07
866,Sweden,SWE,Winter,2010,52869044.29,9378126.0,5.637484961281177,5,2,4,11,15,6,12,33,6.241837817038398e-07
867,United States,USA,Winter,2010,48650643.129999995,309327143.0,0.1572789334235696,9,15,13,37,27,45,39,111,2.2815731274794354e-06
868,Afghanistan,AFG,Summer,2012,663141.0528000001,30466479.0,0.021766251781178917,0,0,1,1,0,0,3,3,4.5239244159790915e-06
869,Argentina,ARG,Summer,2012,13082664.33,41733271.0,0.3134828403457759,1,1,2,4,3,3,6,12,9.172443546138128e-07
870,Armenia,ARM,Summer,2012,3643715.1829999997,2914421.0,1.2502363876049478,0,1,1,2,0,3,3,6,1.6466709659397658e-06
871,Australia,AUS,Summer,2012,68044714.82,22733465.0,2.9931519379029985,8,15,12,35,24,45,36,105,1.5431029474920799e-06
872,Azerbaijan,AZE,Summer,2012,7496294.648,9295784.0,0.8064187644635461,2,2,5,9,6,6,15,27,3.601779448090872e-06
873,Belgium,BEL,Summer,2012,44670560.68,11106932.0,4.021863164373384,0,1,2,3,0,3,6,9,2.0147497284558373e-07
874,Belarus,BLR,Summer,2012,6953132.515000001,9446836.0,0.7360276514803475,2,5,3,10,6,15,9,30,4.314602078312324e-06
875,Brazil,BRA,Summer,2012,12327317.440000001,199977707.0,0.06164345828807809,3,5,9,17,9,15,27,51,4.13715313556491e-06
876,Brunei Darussalam,BRN,Summer,2012,46842960.26,406634.0,115.19686071504104,1,0,0,1,3,0,0,3,6.40437748457531e-08
877,Canada,CAN,Summer,2012,52669089.96,34714222.0,1.5172193679005683,2,6,10,18,6,18,30,54,1.0252692811098648e-06
878,China,CHN,Summer,2012,6300615.118,1354190000.0,0.004652681764006528,38,31,22,91,114,93,66,273,4.3329102776025176e-05
879,Cameroon,CMR,Summer,2012,1433724.035,21032684.0,0.06816648008404443,0,0,1,1,0,0,3,3,2.092452889652506e-06
880,Colombia,COL,Summer,2012,8101829.092,45782417.0,0.17696376956245014,1,3,5,9,3,9,15,27,3.3325807905107063e-06
881,Cuba,CUB,Summer,2012,6467337.914,11309290.0,0.5718606485464605,5,3,7,15,15,9,21,45,6.958040634089558e-06
882,Cyprus,CYP,Summer,2012,28993349.61,1156556.0,25.06869499617831,0,1,0,1,0,3,0,3,1.0347200445461051e-07
883,Czechia,CZE,Summer,2012,19870801.21,10510785.0,1.8905154286763548,4,3,4,11,12,9,12,33,1.6607282037219876e-06
884,Dominican Republic,DOM,Summer,2012,6049471.741,10030882.0,0.6030847278434738,1,1,0,2,3,3,0,6,9.918221386729177e-07
885,"Egypt, Arab Rep.",EGY,Summer,2012,3059135.428,91240376.0,0.03352830799382063,0,3,1,4,0,9,3,12,3.922676940080863e-06
886,Spain,ESP,Summer,2012,28322946.59,46773055.0,0.6055398047016599,4,10,6,20,12,30,18,60,2.118423653744566e-06
887,Estonia,EST,Summer,2012,17403205.330000002,1322696.0,13.157373523470246,0,1,1,2,0,3,3,6,3.447640757106438e-07
888,Ethiopia,ETH,Summer,2012,458550.92079999996,94451280.0,0.004854893663696246,3,2,3,8,9,6,9,24,5.2338789240961444e-05
889,Finland,FIN,Summer,2012,47708061.28,5413971.0,8.812027489618988,0,2,1,3,0,6,3,9,1.8864736395760746e-07
890,France,FRA,Summer,2012,40870852.36,65662240.0,0.6224407263596247,11,11,13,35,33,33,39,105,2.569068026160441e-06
891,Gabon,GAB,Summer,2012,9348515.572,1836705.0,5.089829652557161,0,1,0,1,0,3,0,3,3.20906562854255e-07
892,United Kingdom,GBR,Summer,2012,42485586.07,63700215.0,0.6669614234426053,29,18,18,65,87,54,54,195,4.589791927989755e-06
893,Georgia,GEO,Summer,2012,4421818.242000001,3728874.0,1.18583203454984,1,2,3,6,3,6,9,18,4.070723628807174e-06
894,"Hong Kong SAR, China",HKG,Summer,2012,36730876.7,7150100.0,5.137113704703431,0,0,1,1,0,0,3,3,8.167515369977542e-08
895,Hungary,HUN,Summer,2012,12984836.57,9920362.0,1.308907534825846,8,4,6,18,24,12,18,54,4.158696931524029e-06
896,India,IND,Summer,2012,1434018.198,1274487215.0,0.0011251726820970896,0,2,4,6,0,6,12,18,1.2552141963821855e-05
897,Ireland,IRL,Summer,2012,49054697.43,4599533.0,10.665147403008088,1,1,4,6,3,3,12,18,3.669373361375965e-07
898,Italy,ITA,Summer,2012,35051521.269999996,59539717.0,0.588708227652476,8,9,11,28,24,27,33,84,2.3964723058081415e-06
899,Jamaica,JAM,Summer,2012,5365242.2930000005,2759817.0,1.9440572664781761,4,5,3,12,12,15,9,36,6.709855405219813e-06
900,Japan,JPN,Summer,2012,49145280.43,127629000.0,0.3850635860972036,7,14,17,38,21,42,51,114,2.3196530572732353e-06
901,Kazakhstan,KAZ,Summer,2012,12386699.27,16792090.0,0.7376508385793549,3,1,7,11,9,3,21,33,2.664147992994747e-06
902,Kenya,KEN,Summer,2012,1289780.822,43725806.0,0.029497016521547938,2,4,7,13,6,12,21,39,3.0237695688112815e-05
903,"Korea, Rep.",KOR,Summer,2012,25466760.52,50199853.0,0.5073074719959837,13,9,8,30,39,27,24,90,3.5340183895521237e-06
904,Lithuania,LTU,Summer,2012,14367709.42,2987773.0,4.808835684638693,2,0,3,5,6,0,9,15,1.044007751097739e-06
905,Morocco,MAR,Summer,2012,2907449.219,33352169.0,0.08717421703517993,0,0,1,1,0,0,3,3,1.031832294918579e-06
906,Mexico,MEX,Summer,2012,10376057.67,115755909.0,0.08963739095167919,1,3,4,8,3,9,12,24,2.313017213598428e-06
907,Montenegro,MNE,Summer,2012,6586721.279,620601.0,10.613455793658083,0,1,0,1,0,3,0,3,4.554618106530024e-07
908,Norway,NOR,Summer,2012,101524141.9,5018573.0,20.229683198789775,2,1,1,4,6,3,3,12,1.1819848732944573e-07
909,New Zealand,NZL,Summer,2012,39973380.76,4408100.0,9.068165595154374,6,2,5,13,18,6,15,39,9.75649276055879e-07
910,Poland,POL,Summer,2012,13010923.39,38063164.0,0.34182453644683874,3,2,6,11,9,6,18,33,2.536330359562589e-06
911,"Korea, Dem. People's Rep.",PRK,Summer,2012,0.0,24887770.0,0.0,4,0,3,7,12,0,9,21,0.0
912,Qatar,QAT,Summer,2012,98041362.24000001,1905660.0,51.447457699694596,0,1,1,2,0,3,3,6,6.119866006464008e-08
913,Romania,ROU,Summer,2012,8930729.912,20058035.0,0.44524450735079485,2,4,1,7,6,12,3,21,2.351431541086336e-06
914,Russian Federation,RUS,Summer,2012,15420875.0,143201721.0,0.10768638038924128,19,21,26,66,57,63,78,198,1.2839738341695916e-05
915,Singapore,SGP,Summer,2012,55546488.54,5312437.0,10.45593360260084,0,0,2,2,0,0,6,6,1.0801762915542888e-07
916,Serbia,SRB,Summer,2012,6015945.227999999,7199077.0,0.8356550746713779,1,1,2,4,3,3,6,12,1.9946990115781686e-06
917,Slovak Republic,SVK,Summer,2012,17498353.9,5407579.0,3.2358942698756685,0,1,3,4,0,3,9,12,6.857787920268318e-07
918,Sweden,SWE,Summer,2012,58037821.32,9519374.0,6.096810706250222,1,4,3,8,3,12,9,24,4.1352344822994814e-07
919,Thailand,THA,Summer,2012,5748631.241,69157023.0,0.08312433056871173,0,2,2,4,0,6,6,12,2.0874534296815577e-06
920,Tajikistan,TJK,Summer,2012,959361.905,7956382.0,0.12057765765897113,0,0,1,1,0,0,3,3,3.127078513712716e-06
921,Trinidad and Tobago,TTO,Summer,2012,18961233.59,1430377.0,13.25610911668742,1,1,2,4,3,3,6,12,6.328702161197308e-07
922,Tunisia,TUN,Summer,2012,4233894.568,11174383.0,0.37889291677222803,2,0,1,3,6,0,3,9,2.125702436716889e-06
923,Turkiye,TUR,Summer,2012,11697480.51,75277439.0,0.15539158432315955,1,1,1,3,3,3,3,9,7.693964518518356e-07
924,Uganda,UGA,Summer,2012,796711.135,34273295.0,0.023245828421224163,1,0,0,1,3,0,0,3,3.765480195027022e-06
925,Ukraine,UKR,Summer,2012,4004804.443,45593342.0,0.08783748388087015,5,4,10,19,15,12,30,57,1.4232904705154913e-05
926,United States,USA,Summer,2012,51784418.57,313877662.0,0.16498280967187784,47,27,30,104,141,81,90,312,6.0249783354862145e-06
927,Uzbekistan,UZB,Summer,2012,2267623.275,29774500.0,0.07615991116559472,0,0,3,3,0,0,9,9,3.96891322258985e-06
928,"Venezuela, RB",VEN,Summer,2012,12937927.600000001,29470426.0,0.4390139321365766,1,0,0,1,3,0,0,3,2.31876394176143e-07
929,Australia,AUS,Winter,2014,62513411.22,23475686.0,2.6629002969284903,0,2,1,3,0,6,3,9,1.439691071780869e-07
930,Austria,AUT,Winter,2014,51786377.17,8546356.0,6.059468757210675,4,8,5,17,12,24,15,51,9.84814980058973e-07
931,Belarus,BLR,Winter,2014,8341399.6790000005,9448515.0,0.8828265266023285,5,0,1,6,15,0,3,18,2.157911225056885e-06
932,Canada,CAN,Winter,2014,50955998.32,35437435.0,1.43791440661549,10,10,5,25,30,30,15,75,1.4718581221587574e-06
933,China,CHN,Winter,2014,7636116.601,1371860000.0,0.005566250638549123,3,4,2,9,9,12,6,27,3.535828669308713e-06
934,Czechia,CZE,Winter,2014,19890919.91,10525347.0,1.8898113202348579,2,4,3,9,6,12,9,27,1.3574032836171627e-06
935,Finland,FIN,Winter,2014,50327240.29,5461512.0,9.214891460460034,1,3,1,5,3,9,3,15,2.98049325048735e-07
936,France,FRA,Winter,2014,43068548.72,66312067.0,0.6494828267078449,4,4,7,15,12,12,21,45,1.0448459801270963e-06
937,United Kingdom,GBR,Winter,2014,47447588.93,64602298.0,0.7344566741263601,1,1,3,5,3,3,9,15,3.1613829782014176e-07
938,Italy,ITA,Winter,2014,35565721.38,60789140.0,0.5850670264458422,0,2,6,8,0,6,18,24,6.748070633398185e-07
939,Japan,JPN,Winter,2014,38475395.25,127276000.0,0.30229890356390837,1,4,3,8,3,12,9,24,6.237752684295037e-07
940,Kazakhstan,KAZ,Winter,2014,12807260.69,17288285.0,0.7408057357916068,0,0,1,1,0,0,3,3,2.3424212816581623e-07
941,"Korea, Rep.",KOR,Winter,2014,29249575.22,50746659.0,0.5763842545772323,3,3,2,8,9,9,6,24,8.205247364956434e-07
942,Norway,NOR,Winter,2014,97019182.75,5137232.0,18.885497627905455,11,6,9,26,33,18,27,78,8.039647190287222e-07
943,Poland,POL,Winter,2014,14182137.5,38011735.0,0.3730989258974893,4,1,1,6,12,3,3,18,1.269202191841674e-06
944,Russian Federation,RUS,Winter,2014,14095648.440000001,143819667.0,0.09800918562827712,10,10,9,29,30,30,27,87,6.1721176127743995e-06
945,Slovak Republic,SVK,Winter,2014,18719988.14,5418649.0,3.4547334843057746,1,0,0,1,3,0,0,3,1.602565117864439e-07
946,Sweden,SWE,Winter,2014,60020360.46,9696110.0,6.190148467787598,2,7,6,15,6,21,18,45,7.497455805849387e-07
947,Ukraine,UKR,Winter,2014,3104643.3109999998,45272155.0,0.06857732553265909,1,0,1,2,3,0,3,6,1.93258915726052e-06
948,United States,USA,Winter,2014,55123849.79,318386329.0,0.17313510276378732,9,9,10,28,27,27,30,84,1.523841319501571e-06
949,Argentina,ARG,Summer,2016,12790242.469999999,43590368.0,0.2934190064649144,3,1,0,4,9,3,0,12,9.382152080499222e-07
950,Armenia,ARM,Summer,2016,3679951.972,2865835.0,1.2840767078355872,1,3,0,4,3,9,0,12,3.2609121236650746e-06
951,Australia,AUS,Summer,2016,49875565.14,24190907.0,2.0617484553183556,8,11,10,29,24,33,30,87,1.744341136903256e-06
952,Austria,AUT,Summer,2016,45307587.86,8736668.0,5.1859115923828165,0,0,1,1,0,0,3,3,6.621407454464296e-08
953,Azerbaijan,AZE,Summer,2016,3880738.731,9757812.0,0.397705831081804,1,7,10,18,3,21,30,54,1.3914876456031123e-05
954,Burundi,BDI,Summer,2016,242065.6705,10903327.0,0.022201083256514275,0,1,0,1,0,3,0,3,1.2393331089878768e-05
955,Belgium,BEL,Summer,2016,42012622.72,11331422.0,3.7076214017975855,2,2,2,6,6,6,6,18,4.2844266400514786e-07
956,Belarus,BLR,Summer,2016,5039681.886,9469379.0,0.5322082774382565,1,4,4,9,3,12,12,27,5.357481009863883e-06
957,Brazil,BRA,Summer,2016,8680768.792000001,206859578.0,0.04196454849192432,7,6,6,19,21,18,18,57,6.566238701407403e-06
958,Brunei Darussalam,BRN,Summer,2016,26762945.650000002,425994.0,62.82470093475496,1,1,0,2,3,3,0,6,2.2419056849969726e-07
959,Canada,CAN,Summer,2016,42315603.71,36109487.0,1.1718694234011133,4,3,15,22,12,9,45,66,1.5597083395599273e-06
960,China,CHN,Summer,2016,8094363.367,1387790000.0,0.005832556342818438,26,18,26,70,78,54,78,210,2.5943979838630835e-05
961,Cote d'Ivoire,CIV,Summer,2016,1980878.142,24213622.0,0.08180841932693919,1,0,1,2,3,0,3,6,3.0289596683327933e-06
962,Colombia,COL,Summer,2016,5938463.856000001,47625955.0,0.12468965411822189,3,2,3,8,9,6,9,24,4.041449199989877e-06
963,Cuba,CUB,Summer,2016,8055889.907,11342012.0,0.7102699156904436,5,2,4,11,15,6,12,33,4.096381700962091e-06
964,Czechia,CZE,Summer,2016,18575232.029999997,10566332.0,1.7579640721113057,1,2,7,10,3,6,21,30,1.6150538497472541e-06
965,Dominican Republic,DOM,Summer,2016,7191076.572,10527592.0,0.683069458998791,0,0,1,1,0,0,3,3,4.1718370955485914e-07
966,"Egypt, Arab Rep.",EGY,Summer,2016,3331612.461,99784030.0,0.033388233177192785,0,0,3,3,0,0,9,9,2.70139462658229e-06
967,Spain,ESP,Summer,2016,26537159.49,46484062.0,0.570887275083662,7,4,6,17,21,12,18,51,1.9218334207629997e-06
968,Estonia,EST,Summer,2016,18295342.93,1315790.0,13.904455065017974,0,0,1,1,0,0,3,3,1.6397615565219689e-07
969,Ethiopia,ETH,Summer,2016,705616.305,105293228.0,0.006701440523791331,1,2,5,8,3,6,15,24,3.401281947417584e-05
970,Finland,FIN,Summer,2016,43814026.510000005,5495303.0,7.9729955764040685,0,0,1,1,0,0,3,3,6.84712234634561e-08
971,France,FRA,Summer,2016,37062533.57,66724104.0,0.5554594419132253,10,18,14,42,30,54,42,126,3.3996596525713445e-06
972,United Kingdom,GBR,Summer,2016,41146077.36,65611593.0,0.6271159634852944,27,23,17,67,81,69,51,201,4.885034319101372e-06
973,Georgia,GEO,Summer,2016,4062169.888,3727505.0,1.089782545697457,2,1,4,7,6,3,12,21,5.16965084646898e-06
974,Hungary,HUN,Summer,2016,13104699.549999999,9814023.0,1.3353035294496456,8,3,4,15,24,9,12,45,3.4338826180871886e-06
975,India,IND,Summer,2016,1714280.3550000002,1338636340.0,0.001280616926177277,0,1,1,2,0,3,3,6,3.5000109419092066e-06
976,Ireland,IRL,Summer,2016,62895911.12,4755335.0,13.226389122953481,0,2,0,2,0,6,0,6,9.539570845157987e-08
977,Israel,ISR,Summer,2016,37690473.95,8546000.0,4.410305868242453,0,0,2,2,0,0,6,6,1.5919141818061428e-07
978,Italy,ITA,Summer,2016,30960731.51,60627498.0,0.5106714367464084,8,12,8,28,24,36,24,84,2.713114190240268e-06
979,Jamaica,JAM,Summer,2016,5022704.716999999,2802695.0,1.792098218678807,6,3,2,11,18,9,6,33,6.570165251464454e-06
980,Jordan,JOR,Summer,2016,4003404.749,9964656.0,0.4017604570594308,1,0,0,1,3,0,0,3,7.493621524901678e-07
981,Japan,JPN,Summer,2016,39375473.160000004,127076000.0,0.30985766911139795,12,8,21,41,36,24,63,123,3.123771986185321e-06
982,Kazakhstan,KAZ,Summer,2016,7714841.844,17794055.0,0.43356288625611195,2,5,10,17,6,15,30,51,6.610634544590672e-06
983,Kenya,KEN,Summer,2016,1562076.142,47894670.0,0.03261482210859789,6,6,1,13,18,18,3,39,2.496677271446349e-05
984,"Korea, Rep.",KOR,Summer,2016,29288870.439999998,51217803.0,0.5718494102529154,9,3,9,21,27,9,27,63,2.150987697837623e-06
985,Lithuania,LTU,Summer,2016,15008313.24,2868231.0,5.232602687858823,0,1,3,4,0,3,9,12,7.995568727881908e-07
986,Morocco,MAR,Summer,2016,3132944.58,35107264.0,0.08923921214709298,0,0,1,1,0,0,3,3,9.575656138800897e-07
987,Mexico,MEX,Summer,2016,8875062.256,121519221.0,0.07303422605054388,0,3,2,5,0,9,6,15,1.690128989220242e-06
988,Norway,NOR,Summer,2016,70460560.53,5234519.0,13.460751700395013,0,0,4,4,0,0,12,12,1.7030804055115e-07
989,New Zealand,NZL,Summer,2016,40058196.16,4714100.0,8.497527875946627,4,9,5,18,12,27,15,54,1.3480387330551233e-06
990,Poland,POL,Summer,2016,12378759.44,37970087.0,0.3260134600165651,2,3,6,11,6,9,18,33,2.6658567976824664e-06
991,"Korea, Dem. People's Rep.",PRK,Summer,2016,0.0,25389611.0,0.0,2,3,2,7,6,9,6,21,0.0
992,Qatar,QAT,Summer,2016,58467235.57,2595166.0,22.529285436846816,0,1,0,1,0,3,0,3,5.131078920959491e-08
993,Romania,ROU,Summer,2016,9404341.874,19702267.0,0.4773228316315072,1,1,2,4,3,3,6,12,1.276006355444836e-06
994,Russian Federation,RUS,Summer,2016,8704898.438000001,144342397.0,0.06030728752550785,19,17,20,56,57,51,60,168,1.929947847141097e-05
995,Singapore,SGP,Summer,2016,56860413.24,5607283.0,10.140457194687695,1,0,0,1,3,0,0,3,5.276078433228073e-08
996,Serbia,SRB,Summer,2016,5765200.762,7058322.0,0.8167948078877671,2,4,2,8,6,12,6,24,4.162907935173828e-06
997,Slovak Republic,SVK,Summer,2016,16563440.5,5430798.0,3.049909147790067,2,2,0,4,6,6,0,12,7.244871619516488e-07
998,Sweden,SWE,Summer,2016,51965157.15,9923085.0,5.236794520050972,2,6,3,11,6,18,9,33,6.35040896821381e-07
999,Thailand,THA,Summer,2016,5854461.088,70607037.0,0.08291611341798694,2,2,2,6,6,6,6,18,3.074578467503173e-06
1000,Tajikistan,TJK,Summer,2016,801391.2831,8725318.0,0.09184665625940511,1,0,0,1,3,0,0,3,3.7434896825869903e-06
1001,Trinidad and Tobago,TTO,Summer,2016,15991108.790000001,1469330.0,10.88326569933235,0,0,1,1,0,0,3,3,1.8760425179997789e-07
1002,Tunisia,TUN,Summer,2016,3796167.92,11685667.0,0.32485675999495794,0,0,3,3,0,0,9,9,2.3708118791541763e-06
1003,Turkiye,TUR,Summer,2016,10734379.97,81019394.0,0.13249148679142184,1,3,4,8,3,9,12,24,2.235806825086703e-06
1004,Ukraine,UKR,Summer,2016,2187730.469,45004673.0,0.048611184642981406,2,5,4,11,6,15,12,33,1.5084125063671177e-05
1005,United States,USA,Summer,2016,57866744.93,323071755.0,0.17911421854256496,46,37,38,121,138,111,114,363,6.273032990521798e-06
1006,Uzbekistan,UZB,Summer,2016,2704677.188,31847900.0,0.08492482041202089,4,2,7,13,12,6,21,39,1.441946572146709e-05
1007,"Venezuela, RB",VEN,Summer,2016,0.0,30741464.0,0.0,0,2,1,3,0,6,3,9,0.0
1008,Australia,AUS,Winter,2018,57207871.51,24966643.0,2.291372192488994,0,2,1,3,0,6,3,9,1.5732100779919404e-07
1009,Austria,AUT,Winter,2018,51466556.559999995,8840521.0,5.821665551159258,5,3,6,14,15,9,18,42,8.160639220351991e-07
1010,Belgium,BEL,Winter,2018,47544981.15,11427054.0,4.160738292651807,0,1,0,1,0,3,0,3,6.309814258912584e-08
1011,Belarus,BLR,Winter,2018,6360062.473,9438785.0,0.6738221575128579,2,1,0,3,6,3,0,9,1.4150804395722797e-06
1012,Canada,CAN,Winter,2018,46548638.41,37065084.0,1.2558622128038344,11,8,10,29,33,24,30,87,1.869012778283755e-06
1013,China,CHN,Winter,2018,9905342.004,1402760000.0,0.007061323393880636,1,6,2,9,3,18,6,27,2.7258018944824713e-06
1014,Czechia,CZE,Winter,2018,23424480.459999997,10629928.0,2.2036349126729737,2,2,3,7,6,6,9,21,8.964980049764571e-07
1015,Spain,ESP,Winter,2018,30379721.11,46797754.0,0.6491704945925396,0,0,2,2,0,0,6,6,1.975001672423187e-07
1016,Finland,FIN,Winter,2018,49987626.16,5515525.0,9.063076708019635,1,1,4,6,3,3,12,18,3.6008911370157373e-07
1017,France,FRA,Winter,2018,41557854.86,67158348.0,0.6188040072099451,5,4,6,15,15,12,18,45,1.082827786746835e-06
1018,United Kingdom,GBR,Winter,2018,43306308.3,66460344.0,0.6516112570828703,1,0,4,5,3,0,12,15,3.463698613164863e-07
1019,Hungary,HUN,Winter,2018,16425101.299999999,9775564.0,1.6802203228376387,1,0,0,1,3,0,0,3,1.8264727536261832e-07
1020,Italy,ITA,Winter,2018,34622169.67,60421760.0,0.5730082948593355,3,2,5,10,9,6,15,30,8.66496822294615e-07
1021,Japan,JPN,Winter,2018,39727116.6,126811000.0,0.3132781588348014,4,5,4,13,12,15,12,39,9.81697221892011e-07
1022,Kazakhstan,KAZ,Winter,2018,9812626.371000001,18276452.0,0.5368999612725709,0,0,1,1,0,0,3,3,3.0572854672894993e-07
1023,"Korea, Rep.",KOR,Winter,2018,33436923.060000002,51585058.0,0.6481900836478657,5,8,4,17,15,24,12,51,1.5252599621228425e-06
1024,Liechtenstein,LIE,Winter,2018,175283631.8,38181.0,4590.86016081297,0,0,1,1,0,0,3,3,1.7115117761954085e-08
1025,Norway,NOR,Winter,2018,82267809.32,5311916.0,15.487407805394511,14,14,11,39,42,42,33,117,1.4221844603264076e-06
1026,New Zealand,NZL,Winter,2018,43250440.970000006,4900600.0,8.825539927763948,0,0,2,2,0,0,6,6,1.38726909262308e-07
1027,Poland,POL,Winter,2018,15504580.48,37974750.0,0.4082865714718333,1,0,1,2,3,0,3,6,3.8698241514755257e-07
1028,Slovak Republic,SVK,Winter,2018,19486393.68,5446771.0,3.577604727645058,1,2,0,3,3,6,0,9,4.6186072948106424e-07
1029,Sweden,SWE,Winter,2018,54589060.39,10175214.0,5.364905385773705,7,6,1,14,21,18,3,42,7.693849225456507e-07
1030,Ukraine,UKR,Winter,2018,3096561.768,44622518.0,0.06939459956069714,1,0,0,1,3,0,0,3,9.68816456691459e-07
1031,United States,USA,Winter,2018,62823309.44,326838199.0,0.19221532131866875,9,8,6,23,27,24,18,69,1.0983184524193065e-06
1032,Argentina,ARG,Summer,2020,8496424.141999999,45376763.0,0.18724174181397643,0,1,2,3,0,3,6,9,1.059269152479182e-06
1033,Armenia,ARM,Summer,2020,4505867.364,2805608.0,1.606021712227795,0,2,2,4,0,6,6,12,2.663194237778722e-06
1034,Australia,AUS,Summer,2020,51720370.76,25655289.0,2.015973032305346,17,7,22,46,51,21,66,138,2.6681943298582805e-06
1035,Austria,AUT,Summer,2020,48809226.88,8916864.0,5.473810846503883,1,1,5,7,3,3,15,21,4.3024651981539436e-07
1036,Azerbaijan,AZE,Summer,2020,4229910.649,10093121.0,0.4190884711478244,0,3,4,7,0,9,12,21,4.964643876098102e-06
1037,Belgium,BEL,Summer,2020,45517794.93,11538604.0,3.944826855137762,3,1,3,7,9,3,9,21,4.613580256314055e-07
1038,Belarus,BLR,Summer,2020,6542797.491,9379952.0,0.6975299544176772,1,3,3,7,3,9,9,21,3.209636249461599e-06
1039,Brazil,BRA,Summer,2020,6794489.159,213196304.0,0.03186963859842523,7,6,8,21,21,18,24,63,9.272220254638277e-06
1040,Brunei Darussalam,BRN,Summer,2020,27179411.990000002,441725.0,61.530164672590416,0,1,0,1,0,3,0,3,1.1037766383996006e-07
1041,Canada,CAN,Summer,2020,43258263.870000005,38037204.0,1.1372619257188306,7,6,11,24,21,18,33,72,1.664421859748575e-06
1042,China,CHN,Summer,2020,10408669.76,1411100000.0,0.007376280745517681,38,32,18,88,114,96,54,264,2.5363471614263224e-05
1043,Cote d'Ivoire,CIV,Summer,2020,2288119.498,26811790.0,0.0853400499556352,0,0,1,1,0,0,3,3,1.3111203338034751e-06
1044,Colombia,COL,Summer,2020,5307215.228,50930662.0,0.1042047171505448,0,4,1,5,0,12,3,15,2.826341000994731e-06
1045,Cuba,CUB,Summer,2020,9499590.202,11300698.0,0.8406197742829691,7,3,5,15,21,9,15,45,4.737046445490449e-06
1046,Czechia,CZE,Summer,2020,22992879.38,10697858.0,2.1492974930121522,4,4,3,11,12,12,9,33,1.4352269437252186e-06
1047,Dominican Republic,DOM,Summer,2020,7167919.159,10999664.0,0.6516489193669915,0,3,2,5,0,9,6,15,2.0926575296494637e-06
1048,Ecuador,ECU,Summer,2020,5645199.289999999,17588595.0,0.3209579440540873,2,1,0,3,6,3,0,9,1.5942749826286471e-06
1049,"Egypt, Arab Rep.",EGY,Summer,2020,3398801.432,107465134.0,0.03162701525129071,1,1,4,6,3,3,12,18,5.2959845875456255e-06
1050,Spain,ESP,Summer,2020,26959675.439999998,47365655.0,0.5691819407965539,3,8,6,17,9,24,18,51,1.8917141682029095e-06
1051,Estonia,EST,Summer,2020,23595243.68,1329522.0,17.747163025508417,1,0,1,2,3,0,3,6,2.5428853718877974e-07
1052,Ethiopia,ETH,Summer,2020,918652.5941,117190911.0,0.007838940633373863,1,1,2,4,3,3,6,12,1.306260938799868e-05
1053,Finland,FIN,Summer,2020,49170752.15,5529543.0,8.892371783707985,0,0,2,2,0,0,6,6,1.2202375879255288e-07
1054,France,FRA,Summer,2020,39055282.93,67571107.0,0.5779879102765032,10,12,11,33,30,36,33,99,2.534868334648626e-06
1055,United Kingdom,GBR,Summer,2020,40318557.57,67081000.0,0.601042882038133,22,20,22,64,66,60,66,192,4.7620751230163615e-06
1056,Georgia,GEO,Summer,2020,4255742.993,3722716.0,1.143182287609369,2,5,1,8,6,15,3,24,5.6394382930256995e-06
1057,Ghana,GHA,Summer,2020,2176579.4590000003,32180401.0,0.06763680350036658,0,0,1,1,0,0,3,3,1.3783094329936886e-06
1058,"Hong Kong SAR, China",HKG,Summer,2020,46107765.28,7481000.0,6.163315770618901,1,2,3,6,3,6,9,18,3.903897725402839e-07
1059,Hungary,HUN,Summer,2020,16120989.05,9750149.0,1.6534095068701002,6,7,7,20,18,21,21,60,3.7218560110615544e-06
1060,India,IND,Summer,2020,1910421.473,1396387127.0,0.0013681173623423127,1,2,4,7,3,6,12,21,1.0992338757071748e-05
1061,Ireland,IRL,Summer,2020,85420190.86,4985382.0,17.13413151890868,2,0,2,4,6,0,6,12,1.404820087520933e-07
1062,Israel,ISR,Summer,2020,44846791.599999994,9215100.0,4.866663584768477,2,0,2,4,6,0,6,12,2.6757766992633655e-07
1063,Italy,ITA,Summer,2020,31911035.790000003,59438851.0,0.536871679938766,10,10,20,40,30,30,60,120,3.7604545584071746e-06
1064,Jamaica,JAM,Summer,2020,4897265.897,2820436.0,1.7363506553596677,4,1,4,9,12,3,12,27,5.513280382945889e-06
1065,Jordan,JOR,Summer,2020,4042769.35,10928721.0,0.3699215443417395,0,1,1,2,0,3,3,6,1.4841311686505193e-06
1066,Japan,JPN,Summer,2020,39918167.56,126261000.0,0.31615595916395406,27,14,17,58,81,42,51,174,4.3589175214134e-06
1067,Kazakhstan,KAZ,Summer,2020,9121637.138,18755666.0,0.4863403484579007,0,0,8,8,0,0,24,24,2.6311066354545007e-06
1068,Kenya,KEN,Summer,2020,1936424.589,51985780.0,0.03724912060567332,4,4,2,10,12,12,6,30,1.5492470076251443e-05
1069,Kyrgyz Republic,KGZ,Summer,2020,1182521.7,6579900.0,0.17971727533853096,0,2,1,3,0,6,3,9,7.610853991093779e-06
1070,"Korea, Rep.",KOR,Summer,2020,31721298.91,51836239.0,0.6119521694079696,6,4,10,20,18,12,30,60,1.891473617465433e-06
1071,Lithuania,LTU,Summer,2020,20339521.27,2794885.0,7.277409006095063,0,1,0,1,0,3,0,3,1.474960968931399e-07
1072,Morocco,MAR,Summer,2020,3258121.338,36688772.0,0.0888043169719608,1,0,0,1,3,0,0,3,9.207760205276922e-07
1073,Moldova,MDA,Summer,2020,4500624.464000001,2635130.0,1.7079326120532956,0,0,1,1,0,0,3,3,6.665741663177342e-07
1074,Mexico,MEX,Summer,2020,8655000.682,125998302.0,0.06869140730166348,0,0,4,4,0,0,12,12,1.3864816931738285e-06
1075,North Macedonia,MKD,Summer,2020,5965450.232,2072531.0,2.8783406530469264,0,1,0,1,0,3,0,3,5.028958223316211e-07
1076,Namibia,NAM,Summer,2020,4251172.766,2489098.0,1.7079169908135396,0,1,0,1,0,3,0,3,7.056876220118315e-07
1077,Norway,NOR,Summer,2020,67329677.79,5379475.0,12.516031358078624,4,2,2,8,12,6,6,24,3.5645499559429865e-07
1078,New Zealand,NZL,Summer,2020,41596505.5,5090200.0,8.17188037798122,7,6,7,20,21,18,21,60,1.4424288597992926e-06
1079,Poland,POL,Summer,2020,15816989.4,37899070.0,0.41734505358574764,4,5,5,14,12,15,15,42,2.6553725831035834e-06
1080,Qatar,QAT,Summer,2020,52315660.08,2760385.0,18.952305595052863,2,0,1,3,6,0,3,9,1.7203261865065625e-07
1081,Romania,ROU,Summer,2020,13047432.059999999,19265250.0,0.6772521540078639,1,3,0,4,3,9,0,12,9.197212098761449e-07
1082,San Marino,SMR,Summer,2020,45320208.72,34007.0,1332.6729414532301,0,1,2,3,0,3,6,9,1.985869053605718e-07
1083,Serbia,SRB,Summer,2020,7733802.869,6899126.0,1.1209829866855598,3,1,5,9,9,3,15,27,3.4911673412605572e-06
1084,Slovak Republic,SVK,Summer,2020,19545742.82,5458827.0,3.580575610840937,1,2,1,4,3,6,3,12,6.139444333484789e-07
1085,Sweden,SWE,Summer,2020,52837903.980000004,10353442.0,5.103414302219494,3,6,0,9,9,18,0,27,5.109968027917976e-07
1086,Syrian Arab Republic,SYR,Summer,2020,533385.2317,20772595.0,0.025677351900424573,0,0,1,1,0,0,3,3,5.624452687672717e-06
1087,Thailand,THA,Summer,2020,6990935.503,71475664.0,0.09780861221520096,1,0,1,2,3,0,3,6,8.582542347051032e-07
1088,Turkmenistan,TKM,Summer,2020,0.0,6250438.0,0.0,0,1,0,1,0,3,0,3,0.0
1089,Tunisia,TUN,Summer,2020,3497681.41,12161723.0,0.28759752298255764,1,1,0,2,3,3,0,6,1.715422103009662e-06
1090,Turkiye,TUR,Summer,2020,8561070.948,84135428.0,0.10175346048040548,2,2,9,13,6,6,27,39,4.555504823740657e-06
1091,Uganda,UGA,Summer,2020,846767.2013,44404611.0,0.01906935298453577,2,1,1,4,6,3,3,12,1.4171545593141765e-05
1092,Ukraine,UKR,Summer,2020,3751740.7229999998,44132049.0,0.08501170482702944,1,6,12,19,3,18,36,57,1.5192947543139698e-05
1093,United States,USA,Summer,2020,63530633.48,331501080.0,0.1916453288176316,39,41,33,113,117,123,99,339,5.336008495912766e-06
1094,Uzbekistan,UZB,Summer,2020,1749655.8150000002,34232050.0,0.05111162828402039,3,0,2,5,9,0,6,15,8.573114707134556e-06
1095,"Venezuela, RB",VEN,Summer,2020,0.0,28490453.0,0.0,1,3,0,4,3,9,0,12,0.0
