,Country_Name,Country_Code,Season,Year,GDP,Population,GDP_per_capita,Gold,Silver,Bronze,Total_Medals,Gold_Score,Silver_Score,Bronze_Score,Total_Score,Medal_score_per_GDP,Medal_score_per_capita
0,Argentina,ARG,Summer,1960,0.0,20349744.0,0.0,0,1,1,2,0,2,1,3,0.0,1.474220019671992e-07
1,Australia,AUS,Summer,1960,1810510.2489999998,10276477.0,0.17618005168502784,8,8,6,22,24,16,6,46,2.540720221020964e-05,4.4762421985666875e-06
2,Austria,AUT,Summer,1960,935460.4269,7047539.0,0.13273575738992008,1,1,0,2,3,2,0,5,5.344961535753448e-06,7.094675176682244e-07
3,Austria,AUT,Summer,1960,935460.4269,7047539.0,0.13273575738992008,1,1,0,2,3,2,0,5,5.344961535753448e-06,7.094675176682244e-07
4,Austria,AUT,Winter,1960,935460.4269,7047539.0,0.13273575738992008,1,2,3,6,3,4,3,10,1.0689923071506896e-05,1.4189350353364487e-06
5,Austria,AUT,Winter,1960,935460.4269,7047539.0,0.13273575738992008,1,2,3,6,3,4,3,10,1.0689923071506896e-05,1.4189350353364487e-06
6,Belgium,BEL,Summer,1960,1273691.659,9153489.0,0.13914821539633684,0,2,2,4,0,4,2,6,4.710716253501037e-06,6.554877599131873e-07
7,Brazil,BRA,Summer,1960,232998.7625,73092515.0,0.003187723975567129,0,0,2,2,0,0,2,2,8.583736576712505e-06,2.7362582885538963e-08
8,Canada,CAN,Summer,1960,2259250.5110000004,17909356.0,0.1261491764974687,0,1,0,1,0,2,0,2,8.85249329484383e-07,1.1167347390939127e-07
9,Canada,CAN,Summer,1960,2259250.5110000004,17909356.0,0.1261491764974687,0,1,0,1,0,2,0,2,8.85249329484383e-07,1.1167347390939127e-07
10,Canada,CAN,Winter,1960,2259250.5110000004,17909356.0,0.1261491764974687,2,1,1,4,6,2,1,9,3.983621982679723e-06,5.025306325922607e-07
11,Canada,CAN,Winter,1960,2259250.5110000004,17909356.0,0.1261491764974687,2,1,1,4,6,2,1,9,3.983621982679723e-06,5.025306325922607e-07
12,Spain,ESP,Summer,1960,396392.2533,30455000.0,0.013015670769988507,0,0,1,1,0,0,1,1,2.5227536403017794e-06,3.283533081595797e-08
13,Ethiopia,ETH,Summer,1960,0.0,21739710.0,0.0,1,0,0,1,3,0,0,3,0.0,1.3799632101808165e-07
14,Finland,FIN,Summer,1960,1179353.011,4429634.0,0.26624163779671184,1,1,3,5,3,2,3,8,6.7833803156330775e-06,1.8060182850321268e-06
15,Finland,FIN,Summer,1960,1179353.011,4429634.0,0.26624163779671184,1,1,3,5,3,2,3,8,6.7833803156330775e-06,1.8060182850321268e-06
16,Finland,FIN,Winter,1960,1179353.011,4429634.0,0.26624163779671184,2,3,3,8,6,6,3,15,1.271883809181202e-05,3.386284284435238e-06
17,Finland,FIN,Winter,1960,1179353.011,4429634.0,0.26624163779671184,2,3,3,8,6,6,3,15,1.271883809181202e-05,3.386284284435238e-06
18,France,FRA,Summer,1960,1333881.5729999999,46649927.0,0.028593433233025205,0,2,3,5,0,4,3,7,5.247842193558814e-06,1.5005382537897647e-07
19,France,FRA,Summer,1960,1333881.5729999999,46649927.0,0.028593433233025205,0,2,3,5,0,4,3,7,5.247842193558814e-06,1.5005382537897647e-07
20,France,FRA,Winter,1960,1333881.5729999999,46649927.0,0.028593433233025205,1,0,2,3,3,0,2,5,3.748458709684867e-06,1.0718130384212606e-07
21,France,FRA,Winter,1960,1333881.5729999999,46649927.0,0.028593433233025205,1,0,2,3,3,0,2,5,3.748458709684867e-06,1.0718130384212606e-07
22,United Kingdom,GBR,Summer,1960,1397594.8029999998,52400000.0,0.026671656545801524,2,6,12,20,6,12,12,30,2.1465449023997267e-05,5.725190839694656e-07
23,Ghana,GHA,Summer,1960,176095.64839999998,6911510.0,0.025478607192928892,0,1,0,1,0,2,0,2,1.1357464072348991e-05,2.893723658071825e-07
24,Hungary,HUN,Summer,1960,0.0,9983967.0,0.0,6,8,7,21,18,16,7,41,0.0,4.106584086265509e-06
25,India,IND,Summer,1960,83035.10182,445954579.0,0.00018619632072440273,0,1,0,1,0,2,0,2,2.408619916352383e-05,4.484761664483324e-09
26,Iraq,IRQ,Summer,1960,237713.20789999998,7084678.0,0.033553142132924034,0,0,1,1,0,0,1,1,4.206749842948042e-06,1.4114967539809148e-07
27,Italy,ITA,Summer,1960,804492.6233,50199700.0,0.016025845240110997,13,10,13,36,39,20,13,72,8.949740235610685e-05,1.4342715195509137e-06
28,Italy,ITA,Summer,1960,804492.6233,50199700.0,0.016025845240110997,13,10,13,36,39,20,13,72,8.949740235610685e-05,1.4342715195509137e-06
29,Italy,ITA,Winter,1960,804492.6233,50199700.0,0.016025845240110997,0,0,1,1,0,0,1,1,1.2430194771681507e-06,1.9920437771540467e-08
30,Italy,ITA,Winter,1960,804492.6233,50199700.0,0.016025845240110997,0,0,1,1,0,0,1,1,1.2430194771681507e-06,1.9920437771540467e-08
31,Japan,JPN,Summer,1960,475319.07560000004,93216000.0,0.005099114697047717,4,7,7,18,12,14,7,33,6.942704741724024e-05,3.540164778578785e-07
32,Morocco,MAR,Summer,1960,172598.98380000002,11769774.0,0.014664596261576478,0,1,0,1,0,2,0,2,1.1587553738540607e-05,1.6992679723501913e-07
33,Mexico,MEX,Summer,1960,359545.05970000004,36268055.0,0.009913546775530148,0,0,1,1,0,0,1,1,2.781292561311752e-06,2.7572473902998107e-08
34,Norway,NOR,Summer,1960,1441755.6600000001,3581239.0,0.4025857140503608,1,0,0,1,3,0,0,3,2.0807964090114964e-06,8.376989081153198e-07
35,Norway,NOR,Summer,1960,1441755.6600000001,3581239.0,0.4025857140503608,1,0,0,1,3,0,0,3,2.0807964090114964e-06,8.376989081153198e-07
36,Norway,NOR,Winter,1960,1441755.6600000001,3581239.0,0.4025857140503608,3,3,0,6,9,6,0,15,1.040398204505748e-05,4.188494540576599e-06
37,Norway,NOR,Winter,1960,1441755.6600000001,3581239.0,0.4025857140503608,3,3,0,6,9,6,0,15,1.040398204505748e-05,4.188494540576599e-06
38,New Zealand,NZL,Summer,1960,2312949.9919999996,2371800.0,0.9751876178429882,2,0,1,3,6,0,1,7,3.026438108999981e-06,2.9513449700649296e-06
39,Pakistan,PAK,Summer,1960,81586.9473,45954226.0,0.0017753959624953752,1,0,1,2,3,0,1,4,4.902745025244988e-05,8.704313722964239e-08
40,Poland,POL,Summer,1960,0.0,29637450.0,0.0,4,6,11,21,12,12,11,35,0.0,1.1809383060958348e-06
41,Poland,POL,Summer,1960,0.0,29637450.0,0.0,4,6,11,21,12,12,11,35,0.0,1.1809383060958348e-06
42,Poland,POL,Winter,1960,0.0,29637450.0,0.0,0,1,1,2,0,2,1,3,0.0,1.0122328337964299e-07
43,Poland,POL,Winter,1960,0.0,29637450.0,0.0,0,1,1,2,0,2,1,3,0.0,1.0122328337964299e-07
44,Romania,ROU,Summer,1960,0.0,18406905.0,0.0,3,1,6,10,9,2,6,17,0.0,9.235664550884572e-07
45,Singapore,SGP,Summer,1960,428058.98000000004,1646400.0,0.25999695092322644,0,1,0,1,0,2,0,2,4.6722533422847476e-06,1.2147716229348882e-06
46,Sweden,SWE,Summer,1960,2114002.973,7484656.0,0.2824449076884763,1,2,3,6,3,4,3,10,4.730362316288e-06,1.3360667477570111e-06
47,Sweden,SWE,Summer,1960,2114002.973,7484656.0,0.2824449076884763,1,2,3,6,3,4,3,10,4.730362316288e-06,1.3360667477570111e-06
48,Sweden,SWE,Winter,1960,2114002.973,7484656.0,0.2824449076884763,3,2,2,7,9,4,2,15,7.095543474432e-06,2.004100121635517e-06
49,Sweden,SWE,Winter,1960,2114002.973,7484656.0,0.2824449076884763,3,2,2,7,9,4,2,15,7.095543474432e-06,2.004100121635517e-06
50,Turkiye,TUR,Summer,1960,508290.6132,27510980.0,0.01847591809524779,7,2,0,9,21,4,0,25,4.918446131162982e-05,9.087280787525562e-07
51,United States,USA,Summer,1960,3007123.4450000003,180671000.0,0.01664419549900095,34,21,16,71,102,42,16,160,5.320699430082758e-05,8.855876150572034e-07
52,United States,USA,Summer,1960,3007123.4450000003,180671000.0,0.01664419549900095,34,21,16,71,102,42,16,160,5.320699430082758e-05,8.855876150572034e-07
53,United States,USA,Winter,1960,3007123.4450000003,180671000.0,0.01664419549900095,3,4,3,10,9,8,3,20,6.650874287603447e-06,1.1069845188215043e-07
54,United States,USA,Winter,1960,3007123.4450000003,180671000.0,0.01664419549900095,3,4,3,10,9,8,3,20,6.650874287603447e-06,1.1069845188215043e-07
55,"Venezuela, RB",VEN,Summer,1960,953677.9441999999,8156937.0,0.1169161836360879,0,0,1,1,0,0,1,1,1.0485720112137621e-06,1.2259503781873024e-07
56,Argentina,ARG,Summer,1964,1179504.098,21708487.0,0.05433377729180297,0,1,0,1,0,2,0,2,1.6956278519008588e-06,9.212986607495953e-08
57,Australia,AUS,Summer,1964,2131277.657,11167000.0,0.1908549885376556,6,2,10,18,18,4,10,32,1.5014467915477236e-05,2.8655861019074057e-06
58,Austria,AUT,Winter,1964,1269412.583,7223801.0,0.17572640539239662,4,5,3,12,12,10,3,25,1.9694148565092643e-05,3.4607819346075563e-06
59,Belgium,BEL,Summer,1964,1701846.276,9378113.0,0.1814700117177091,2,0,1,3,6,0,1,7,4.113179961501999e-06,7.46418815810814e-07
60,Brazil,BRA,Summer,1964,254838.581,82262794.0,0.0030978595378124405,0,0,1,1,0,0,1,1,3.924052614309605e-06,1.2156163818116851e-08
61,Canada,CAN,Summer,1964,2555111.146,19325000.0,0.13221791182406212,1,2,1,4,3,4,1,8,3.1309792579958475e-06,4.1397153945666237e-07
62,Canada,CAN,Summer,1964,2555111.146,19325000.0,0.13221791182406212,1,2,1,4,3,4,1,8,3.1309792579958475e-06,4.1397153945666237e-07
63,Canada,CAN,Winter,1964,2555111.146,19325000.0,0.13221791182406212,1,1,1,3,3,2,1,6,2.3482344434968855e-06,3.1047865459249674e-07
64,Canada,CAN,Winter,1964,2555111.146,19325000.0,0.13221791182406212,1,1,1,3,3,2,1,6,2.3482344434968855e-06,3.1047865459249674e-07
65,Cuba,CUB,Summer,1964,0.0,7902286.0,0.0,0,1,0,1,0,2,0,2,0.0,2.530913206634131e-07
66,Ethiopia,ETH,Summer,1964,0.0,24073696.0,0.0,1,0,0,1,3,0,0,3,0.0,1.24617341682806e-07
67,Finland,FIN,Summer,1964,1707503.938,4548543.0,0.3753957999297797,3,0,2,5,9,0,2,11,6.442152053180213e-06,2.418356823272859e-06
68,Finland,FIN,Summer,1964,1707503.938,4548543.0,0.3753957999297797,3,0,2,5,9,0,2,11,6.442152053180213e-06,2.418356823272859e-06
69,Finland,FIN,Winter,1964,1707503.938,4548543.0,0.3753957999297797,3,4,3,10,9,8,3,20,1.1713003733054933e-05,4.397012405950653e-06
70,Finland,FIN,Winter,1964,1707503.938,4548543.0,0.3753957999297797,3,4,3,10,9,8,3,20,1.1713003733054933e-05,4.397012405950653e-06
71,France,FRA,Summer,1964,1928999.402,48733997.0,0.03958221202336431,1,8,6,15,3,16,6,25,1.296008696222499e-05,5.12988909980029e-07
72,France,FRA,Summer,1964,1928999.402,48733997.0,0.03958221202336431,1,8,6,15,3,16,6,25,1.296008696222499e-05,5.12988909980029e-07
73,France,FRA,Winter,1964,1928999.402,48733997.0,0.03958221202336431,3,4,0,7,9,8,0,17,8.812859134312992e-06,3.488324587864197e-07
74,France,FRA,Winter,1964,1928999.402,48733997.0,0.03958221202336431,3,4,0,7,9,8,0,17,8.812859134312992e-06,3.488324587864197e-07
75,United Kingdom,GBR,Summer,1964,1748288.118,54000000.0,0.03237570588888889,4,12,2,18,12,24,2,38,2.1735547824617773e-05,7.037037037037037e-07
76,United Kingdom,GBR,Summer,1964,1748288.118,54000000.0,0.03237570588888889,4,12,2,18,12,24,2,38,2.1735547824617773e-05,7.037037037037037e-07
77,United Kingdom,GBR,Winter,1964,1748288.118,54000000.0,0.03237570588888889,1,0,0,1,3,0,0,3,1.7159643019435083e-06,5.5555555555555555e-08
78,United Kingdom,GBR,Winter,1964,1748288.118,54000000.0,0.03237570588888889,1,0,0,1,3,0,0,3,1.7159643019435083e-06,5.5555555555555555e-08
79,Ghana,GHA,Summer,1964,226576.967,7640196.0,0.02965591026722351,0,0,1,1,0,0,1,1,4.413511281577001e-06,1.308866945298262e-07
80,Hungary,HUN,Summer,1964,0.0,10119835.0,0.0,10,7,5,22,30,14,5,49,0.0,4.84197617846536e-06
81,India,IND,Summer,1964,115487.6084,489059309.0,0.00023614233749305854,1,0,0,1,3,0,0,3,2.5976812937447583e-05,6.1342253276687965e-09
82,Ireland,IRL,Summer,1964,965135.4227,2866550.0,0.33668884990668224,0,0,1,1,0,0,1,1,1.0361240262039757e-06,3.488514067432977e-07
83,Italy,ITA,Summer,1964,1222544.54,51675350.0,0.02365817628714658,10,10,7,27,30,20,7,57,4.66240681914133e-05,1.1030404244963992e-06
84,Italy,ITA,Summer,1964,1222544.54,51675350.0,0.02365817628714658,10,10,7,27,30,20,7,57,4.66240681914133e-05,1.1030404244963992e-06
85,Italy,ITA,Winter,1964,1222544.54,51675350.0,0.02365817628714658,0,1,3,4,0,2,3,5,4.089830543106429e-06,9.675793197336835e-08
86,Italy,ITA,Winter,1964,1222544.54,51675350.0,0.02365817628714658,0,1,3,4,0,2,3,5,4.089830543106429e-06,9.675793197336835e-08
87,Japan,JPN,Summer,1964,843616.8785,96903000.0,0.008705787008658143,16,5,8,29,48,10,8,66,7.823456557359526e-05,6.810934645986192e-07
88,Kenya,KEN,Summer,1964,110392.0208,9047387.0,0.01220153628887545,0,0,1,1,0,0,1,1,9.058625729949497e-06,1.1052915057131966e-07
89,"Korea, Rep.",KOR,Summer,1964,123606.83690000001,27984155.0,0.0044170294547039215,0,2,1,3,0,4,1,5,4.0450836906740714e-05,1.7867253808449817e-07
90,Mexico,MEX,Summer,1964,485800.05,41333878.0,0.011753072140968723,0,0,1,1,0,0,1,1,2.058460059853843e-06,2.4193229582765014e-08
91,Norway,NOR,Winter,1964,1937884.614,3694339.0,0.5245551677850896,3,6,6,15,9,12,6,27,1.3932718080809326e-05,7.3084792705812865e-06
92,New Zealand,NZL,Summer,1964,2813546.9760000003,2585400.0,1.088244362961244,3,0,2,5,9,0,2,11,3.9096557099745395e-06,4.254660787499033e-06
93,Pakistan,PAK,Summer,1964,102961.2072,50552592.0,0.0020367146990207742,0,1,0,1,0,2,0,2,1.9424791670469068e-05,3.956275872066065e-08
94,Poland,POL,Summer,1964,0.0,31139450.0,0.0,7,6,10,23,21,12,10,43,0.0,1.3808850188426579e-06
95,"Korea, Dem. People's Rep.",PRK,Winter,1964,0.0,12787523.0,0.0,0,1,0,1,0,2,0,2,0.0,1.564024557375185e-07
96,Romania,ROU,Summer,1964,0.0,18919126.0,0.0,2,4,6,12,6,8,6,20,0.0,1.0571312860858373e-06
97,Sweden,SWE,Summer,1964,2941048.8989999997,7661354.0,0.3838810866851995,2,2,4,8,6,4,4,14,4.760206470813936e-06,1.827353232861972e-06
98,Sweden,SWE,Summer,1964,2941048.8989999997,7661354.0,0.3838810866851995,2,2,4,8,6,4,4,14,4.760206470813936e-06,1.827353232861972e-06
99,Sweden,SWE,Winter,1964,2941048.8989999997,7661354.0,0.3838810866851995,3,3,1,7,9,6,1,16,5.440235966644498e-06,2.0884036946993966e-06
100,Sweden,SWE,Winter,1964,2941048.8989999997,7661354.0,0.3838810866851995,3,3,1,7,9,6,1,16,5.440235966644498e-06,2.0884036946993966e-06
101,Trinidad and Tobago,TTO,Summer,1964,779389.2566,913399.0,0.8532845520960719,0,1,2,3,0,2,2,4,5.132223681719146e-06,4.379247185512574e-06
102,Tunisia,TUN,Summer,1964,0.0,4389417.0,0.0,0,1,1,2,0,2,1,3,0.0,6.834620634129772e-07
103,Turkiye,TUR,Summer,1964,365133.8692,30612821.0,0.011927481926608464,2,3,1,6,6,6,1,13,3.56033802848328e-05,4.2465867487351136e-07
104,United States,USA,Summer,1964,3573941.185,191889000.0,0.01862504460912298,36,26,28,90,108,52,28,188,5.260299212226684e-05,9.797330748505647e-07
105,United States,USA,Summer,1964,3573941.185,191889000.0,0.01862504460912298,36,26,28,90,108,52,28,188,5.260299212226684e-05,9.797330748505647e-07
106,United States,USA,Winter,1964,3573941.185,191889000.0,0.01862504460912298,1,2,4,7,3,4,4,11,3.077834645451783e-06,5.732480757104368e-08
107,United States,USA,Winter,1964,3573941.185,191889000.0,0.01862504460912298,1,2,4,7,3,4,4,11,3.077834645451783e-06,5.732480757104368e-08
108,Argentina,ARG,Summer,1968,1143810.428,23112971.0,0.04948781478590528,0,0,2,2,0,0,2,2,1.7485414986966702e-06,8.653149783297007e-08
109,Australia,AUS,Summer,1968,2723999.484,12009000.0,0.226829834624032,5,7,5,17,15,14,5,34,1.2481647004599798e-05,2.8312099258889166e-06
110,Austria,AUT,Summer,1968,1677673.528,7415403.0,0.22624171983639998,0,2,2,4,0,4,2,6,3.5763811610908366e-06,8.09126624675692e-07
111,Austria,AUT,Summer,1968,1677673.528,7415403.0,0.22624171983639998,0,2,2,4,0,4,2,6,3.5763811610908366e-06,8.09126624675692e-07
112,Austria,AUT,Winter,1968,1677673.528,7415403.0,0.22624171983639998,3,4,4,11,9,8,4,21,1.2517334063817928e-05,2.831943186364922e-06
113,Austria,AUT,Winter,1968,1677673.528,7415403.0,0.22624171983639998,3,4,4,11,9,8,4,21,1.2517334063817928e-05,2.831943186364922e-06
114,Belgium,BEL,Summer,1968,2222361.511,9618756.0,0.23104458736659916,0,1,1,2,0,2,1,3,1.3499153873710155e-06,3.1189064365495915e-07
115,Brazil,BRA,Summer,1968,370180.4118,91659246.0,0.0040386587055276455,0,1,2,3,0,2,2,4,1.0805542034355692e-05,4.363989640499552e-08
116,Canada,CAN,Summer,1968,3462678.872,20744000.0,0.16692435750096413,1,3,1,5,3,6,1,10,2.887937452376034e-06,4.820671037408407e-07
117,Canada,CAN,Summer,1968,3462678.872,20744000.0,0.16692435750096413,1,3,1,5,3,6,1,10,2.887937452376034e-06,4.820671037408407e-07
118,Canada,CAN,Winter,1968,3462678.872,20744000.0,0.16692435750096413,1,1,1,3,3,2,1,6,1.7327624714256206e-06,2.8924026224450444e-07
119,Canada,CAN,Winter,1968,3462678.872,20744000.0,0.16692435750096413,1,1,1,3,3,2,1,6,1.7327624714256206e-06,2.8924026224450444e-07
120,Cameroon,CMR,Summer,1968,170745.5914,6127193.0,0.027866853777904498,0,1,0,1,0,2,0,2,1.1713333173649366e-05,3.2641374280196496e-07
121,Cuba,CUB,Summer,1968,0.0,8550286.0,0.0,0,4,0,4,0,8,0,8,0.0,9.356412171475902e-07
122,Ethiopia,ETH,Summer,1968,0.0,26778653.0,0.0,1,1,0,2,3,2,0,5,0.0,1.8671588895826836e-07
123,Finland,FIN,Summer,1968,1907077.2719999999,4626469.0,0.4122101049418033,1,2,1,4,3,4,1,8,4.194900813646737e-06,1.7291805046137778e-06
124,Finland,FIN,Summer,1968,1907077.2719999999,4626469.0,0.4122101049418033,1,2,1,4,3,4,1,8,4.194900813646737e-06,1.7291805046137778e-06
125,Finland,FIN,Winter,1968,1907077.2719999999,4626469.0,0.4122101049418033,1,2,2,5,3,4,2,9,4.71926341535258e-06,1.9453280676905e-06
126,Finland,FIN,Winter,1968,1907077.2719999999,4626469.0,0.4122101049418033,1,2,2,5,3,4,2,9,4.71926341535258e-06,1.9453280676905e-06
127,France,FRA,Summer,1968,2553975.8430000003,50817020.0,0.05025827651837909,7,3,5,15,21,6,5,32,1.2529484210943649e-05,6.297102821062707e-07
128,France,FRA,Summer,1968,2553975.8430000003,50817020.0,0.05025827651837909,7,3,5,15,21,6,5,32,1.2529484210943649e-05,6.297102821062707e-07
129,France,FRA,Winter,1968,2553975.8430000003,50817020.0,0.05025827651837909,4,3,2,9,12,6,2,20,7.83092763183978e-06,3.935689263164192e-07
130,France,FRA,Winter,1968,2553975.8430000003,50817020.0,0.05025827651837909,4,3,2,9,12,6,2,20,7.83092763183978e-06,3.935689263164192e-07
131,United Kingdom,GBR,Summer,1968,1951758.596,55211700.0,0.03535045282068837,5,5,3,13,15,10,3,28,1.434603647058819e-05,5.071388854174025e-07
132,Hungary,HUN,Summer,1968,0.0,10255815.0,0.0,10,10,12,32,30,20,12,62,0.0,6.045350857050366e-06
133,India,IND,Summer,1968,99516.83611999999,533431909.0,0.0001865595860333132,0,0,1,1,0,0,1,1,1.0048550968744364e-05,1.8746535089635965e-09
134,Italy,ITA,Summer,1968,1651939.3769999999,53235750.0,0.031030639692312026,3,4,9,16,9,8,9,26,1.573907636200139e-05,4.883936076790503e-07
135,Italy,ITA,Summer,1968,1651939.3769999999,53235750.0,0.031030639692312026,3,4,9,16,9,8,9,26,1.573907636200139e-05,4.883936076790503e-07
136,Italy,ITA,Winter,1968,1651939.3769999999,53235750.0,0.031030639692312026,4,0,0,4,12,0,0,12,7.264189090154488e-06,2.2541243431340782e-07
137,Italy,ITA,Winter,1968,1651939.3769999999,53235750.0,0.031030639692312026,4,0,0,4,12,0,0,12,7.264189090154488e-06,2.2541243431340782e-07
138,Jamaica,JAM,Summer,1968,598100.6359,1812209.0,0.3300395461561001,0,1,0,1,0,2,0,2,3.3439188657448473e-06,1.1036254648332504e-06
139,Japan,JPN,Summer,1968,1451337.703,101011000.0,0.014368115383473087,11,7,7,25,33,14,7,54,3.720705380172984e-05,5.345952421023453e-07
140,Kenya,KEN,Summer,1968,127502.46280000001,10613877.0,0.012012807647949944,3,4,2,9,9,8,2,19,0.0001490167294243041,1.7901093069007678e-06
141,"Korea, Rep.",KOR,Summer,1968,198431.298,30838302.0,0.006434572759550769,0,1,1,2,0,2,1,3,1.5118582755024864e-05,9.728162075849701e-08
142,Mexico,MEX,Summer,1968,622425.0634,47170337.0,0.013195264290776637,3,3,3,9,9,6,3,18,2.8919143939472668e-05,3.815957473443533e-07
143,Norway,NOR,Summer,1968,2662117.492,3816486.0,0.6975310513388494,1,1,0,2,3,2,0,5,1.8782041044490458e-06,1.310105683605285e-06
144,Norway,NOR,Summer,1968,2662117.492,3816486.0,0.6975310513388494,1,1,0,2,3,2,0,5,1.8782041044490458e-06,1.310105683605285e-06
145,Norway,NOR,Winter,1968,2662117.492,3816486.0,0.6975310513388494,6,6,2,14,18,12,2,32,1.2020506268473894e-05,8.384676375073825e-06
146,Norway,NOR,Winter,1968,2662117.492,3816486.0,0.6975310513388494,6,6,2,14,18,12,2,32,1.2020506268473894e-05,8.384676375073825e-06
147,New Zealand,NZL,Summer,1968,1885156.152,2748100.0,0.6859852814671955,1,0,2,3,3,0,2,5,2.6523001793222273e-06,1.8194388850478512e-06
148,Pakistan,PAK,Summer,1968,143287.94629999998,56124743.0,0.002553026323880004,1,0,0,1,3,0,0,3,2.0936862293489376e-05,5.3452360574729044e-08
149,Poland,POL,Summer,1968,0.0,32294655.0,0.0,5,2,11,18,15,4,11,30,0.0,9.289462915767331e-07
150,Romania,ROU,Summer,1968,0.0,19799831.0,0.0,4,6,5,15,12,12,5,29,0.0,1.4646589660285483e-06
151,Romania,ROU,Summer,1968,0.0,19799831.0,0.0,4,6,5,15,12,12,5,29,0.0,1.4646589660285483e-06
152,Romania,ROU,Winter,1968,0.0,19799831.0,0.0,0,0,1,1,0,0,1,1,0.0,5.050548158719132e-08
153,Romania,ROU,Winter,1968,0.0,19799831.0,0.0,0,0,1,1,0,0,1,1,0.0,5.050548158719132e-08
154,Sweden,SWE,Summer,1968,3926409.001,7912273.0,0.4962428623228749,2,1,1,4,6,2,1,9,2.2921707844770703e-06,1.137473391021771e-06
155,Sweden,SWE,Summer,1968,3926409.001,7912273.0,0.4962428623228749,2,1,1,4,6,2,1,9,2.2921707844770703e-06,1.137473391021771e-06
156,Sweden,SWE,Winter,1968,3926409.001,7912273.0,0.4962428623228749,3,2,3,8,9,4,3,16,4.074970283514792e-06,2.022174917372037e-06
157,Sweden,SWE,Winter,1968,3926409.001,7912273.0,0.4962428623228749,3,2,3,8,9,4,3,16,4.074970283514792e-06,2.022174917372037e-06
158,Tunisia,TUN,Summer,1968,253848.674,4785003.0,0.05305089129515697,1,0,1,2,3,0,1,4,1.575741931982674e-05,8.359451394283348e-07
159,Turkiye,TUR,Summer,1968,516466.80630000005,33884075.0,0.015242169257977384,2,0,0,2,6,0,0,6,1.161739714306979e-05,1.7707433359181266e-07
160,Uganda,UGA,Summer,1968,107031.3041,9696370.0,0.011038285884305157,0,1,1,2,0,2,1,3,2.8029182912665268e-05,3.0939413409348036e-07
161,United States,USA,Summer,1968,4695923.39,200706000.0,0.02339702545016093,45,28,34,107,135,56,34,225,4.791389920864957e-05,1.1210427192012197e-06
162,United States,USA,Summer,1968,4695923.39,200706000.0,0.02339702545016093,45,28,34,107,135,56,34,225,4.791389920864957e-05,1.1210427192012197e-06
163,United States,USA,Winter,1968,4695923.39,200706000.0,0.02339702545016093,1,5,1,7,3,10,1,14,2.9813092840937513e-06,6.975376919474256e-08
164,United States,USA,Winter,1968,4695923.39,200706000.0,0.02339702545016093,1,5,1,7,3,10,1,14,2.9813092840937513e-06,6.975376919474256e-08
165,"Venezuela, RB",VEN,Summer,1968,940201.4199,10672654.0,0.08809443460829892,1,0,0,1,3,0,0,3,3.190805647069838e-06,2.810922194235848e-07
166,Argentina,ARG,Summer,1972,1411176.664,24612794.0,0.05733508613447137,0,1,0,1,0,2,0,2,1.4172569962508959e-06,8.125855195472728e-08
167,Australia,AUS,Summer,1972,3949461.643,13177000.0,0.299723885785839,8,7,2,17,24,14,2,40,1.012796264799678e-05,3.0355923199514306e-06
168,Austria,AUT,Summer,1972,2924048.8789999997,7544201.0,0.38758894136039057,0,1,2,3,0,2,2,4,1.367966188502282e-06,5.30208566818408e-07
169,Austria,AUT,Summer,1972,2924048.8789999997,7544201.0,0.38758894136039057,0,1,2,3,0,2,2,4,1.367966188502282e-06,5.30208566818408e-07
170,Austria,AUT,Winter,1972,2924048.8789999997,7544201.0,0.38758894136039057,1,2,2,5,3,4,2,9,3.0779239241301345e-06,1.192969275341418e-06
171,Austria,AUT,Winter,1972,2924048.8789999997,7544201.0,0.38758894136039057,1,2,2,5,3,4,2,9,3.0779239241301345e-06,1.192969275341418e-06
172,Belgium,BEL,Summer,1972,3831631.9,9711115.0,0.3945614792946021,0,2,0,2,0,4,0,4,1.0439416166255428e-06,4.1189914855297255e-07
173,Brazil,BRA,Summer,1972,577451.5371999999,101194394.0,0.005706358962928321,0,0,2,2,0,0,2,2,3.4634941136320874e-06,1.9763940678373942e-08
174,Canada,CAN,Summer,1972,5089587.902,22218463.0,0.2290702062514405,0,2,3,5,0,4,3,7,1.375356931599371e-06,3.150532959908163e-07
175,Canada,CAN,Summer,1972,5089587.902,22218463.0,0.2290702062514405,0,2,3,5,0,4,3,7,1.375356931599371e-06,3.150532959908163e-07
176,Canada,CAN,Winter,1972,5089587.902,22218463.0,0.2290702062514405,0,1,0,1,0,2,0,2,3.92959123314106e-07,9.001522742594752e-08
177,Canada,CAN,Winter,1972,5089587.902,22218463.0,0.2290702062514405,0,1,0,1,0,2,0,2,3.92959123314106e-07,9.001522742594752e-08
178,Colombia,COL,Summer,1972,395987.6223,21898055.0,0.018083232611298128,0,1,2,3,0,2,2,4,1.0101325836315163e-05,1.8266462478060266e-07
179,Cuba,CUB,Summer,1972,887217.1977,9169289.0,0.09675965036111306,3,1,4,8,9,2,4,15,1.6906795809285065e-05,1.6358956512331546e-06
180,Spain,ESP,Summer,1972,1708808.6290000002,34604469.0,0.049381154468805755,0,0,1,1,0,0,1,1,5.852030373847087e-07,2.8898001584708612e-08
181,Spain,ESP,Summer,1972,1708808.6290000002,34604469.0,0.049381154468805755,0,0,1,1,0,0,1,1,5.852030373847087e-07,2.8898001584708612e-08
182,Spain,ESP,Winter,1972,1708808.6290000002,34604469.0,0.049381154468805755,1,0,0,1,3,0,0,3,1.7556091121541263e-06,8.669400475412583e-08
183,Spain,ESP,Winter,1972,1708808.6290000002,34604469.0,0.049381154468805755,1,0,0,1,3,0,0,3,1.7556091121541263e-06,8.669400475412583e-08
184,Ethiopia,ETH,Summer,1972,0.0,29891328.0,0.0,0,0,2,2,0,0,2,2,0.0,6.690903796579396e-08
185,Finland,FIN,Summer,1972,3177645.701,4639657.0,0.6848880641392241,3,1,4,8,9,2,4,15,4.720475915637645e-06,3.2329976116768976e-06
186,Finland,FIN,Summer,1972,3177645.701,4639657.0,0.6848880641392241,3,1,4,8,9,2,4,15,4.720475915637645e-06,3.2329976116768976e-06
187,Finland,FIN,Winter,1972,3177645.701,4639657.0,0.6848880641392241,0,4,1,5,0,8,1,9,2.832285549382587e-06,1.9397985670061385e-06
188,Finland,FIN,Winter,1972,3177645.701,4639657.0,0.6848880641392241,0,4,1,5,0,8,1,9,2.832285549382587e-06,1.9397985670061385e-06
189,France,FRA,Summer,1972,3865925.4,52637888.0,0.073443778747354,2,4,7,13,6,8,7,21,5.432075849161497e-06,3.989521768046621e-07
190,France,FRA,Summer,1972,3865925.4,52637888.0,0.073443778747354,2,4,7,13,6,8,7,21,5.432075849161497e-06,3.989521768046621e-07
191,France,FRA,Winter,1972,3865925.4,52637888.0,0.073443778747354,0,1,2,3,0,2,2,4,1.0346811141259994e-06,7.599089081993563e-08
192,France,FRA,Winter,1972,3865925.4,52637888.0,0.073443778747354,0,1,2,3,0,2,2,4,1.0346811141259994e-06,7.599089081993563e-08
193,United Kingdom,GBR,Summer,1972,3030432.514,56086065.0,0.05403182615860107,4,5,9,18,12,10,9,31,1.0229562894664744e-05,5.527219640030014e-07
194,Ghana,GHA,Summer,1972,225528.9099,9365952.0,0.0240796568143847,0,0,1,1,0,0,1,1,4.434021343176811e-06,1.067697122513547e-07
195,Hungary,HUN,Summer,1972,0.0,10398489.0,0.0,6,13,16,35,18,26,16,60,0.0,5.770069093692363e-06
196,India,IND,Summer,1972,122612.45340000001,582837973.0,0.00021037142238499964,0,0,1,1,0,0,1,1,8.155778408068294e-06,1.715742704362195e-09
197,Italy,ITA,Summer,1972,2671137.3140000002,54381345.0,0.049118632759083104,5,3,10,18,15,6,10,31,1.1605543390645771e-05,5.700484237747338e-07
198,Italy,ITA,Summer,1972,2671137.3140000002,54381345.0,0.049118632759083104,5,3,10,18,15,6,10,31,1.1605543390645771e-05,5.700484237747338e-07
199,Italy,ITA,Winter,1972,2671137.3140000002,54381345.0,0.049118632759083104,2,2,1,5,6,4,1,11,4.118096041842048e-06,2.022752471458733e-07
200,Italy,ITA,Winter,1972,2671137.3140000002,54381345.0,0.049118632759083104,2,2,1,5,6,4,1,11,4.118096041842048e-06,2.022752471458733e-07
201,Jamaica,JAM,Summer,1972,978984.9312999999,1915299.0,0.511139478118038,0,0,1,1,0,0,1,1,1.0214661819892304e-06,5.221116911772e-07
202,Japan,JPN,Summer,1972,2967041.996,107188000.0,0.02768072914878531,13,8,8,29,39,16,8,63,2.1233268718451938e-05,5.877523603388439e-07
203,Japan,JPN,Summer,1972,2967041.996,107188000.0,0.02768072914878531,13,8,8,29,39,16,8,63,2.1233268718451938e-05,5.877523603388439e-07
204,Japan,JPN,Winter,1972,2967041.996,107188000.0,0.02768072914878531,1,1,1,3,3,2,1,6,2.0222160684239943e-06,5.597641527036609e-08
205,Japan,JPN,Winter,1972,2967041.996,107188000.0,0.02768072914878531,1,1,1,3,3,2,1,6,2.0222160684239943e-06,5.597641527036609e-08
206,Kenya,KEN,Summer,1972,171005.09170000002,12322903.0,0.013877013533255923,2,3,4,9,6,6,4,16,9.356446548427539e-05,1.2983953537571464e-06
207,"Korea, Rep.",KOR,Summer,1972,324196.2768,33505406.0,0.009675939363337367,0,1,0,1,0,2,0,2,6.169102309690683e-06,5.969185987479155e-08
208,Lebanon,LBN,Summer,1972,0.0,2505965.0,0.0,0,1,0,1,0,2,0,2,0.0,7.980957435558757e-07
209,Mexico,MEX,Summer,1972,844174.4381,53543436.0,0.015766161105163292,0,1,0,1,0,2,0,2,2.3691785841104585e-06,3.735285124398815e-08
210,Norway,NOR,Summer,1972,4413575.692000001,3933004.0,1.122189474508544,2,1,1,4,6,2,1,9,2.0391629436226283e-06,2.2883271921411726e-06
211,Norway,NOR,Summer,1972,4413575.692000001,3933004.0,1.122189474508544,2,1,1,4,6,2,1,9,2.0391629436226283e-06,2.2883271921411726e-06
212,Norway,NOR,Winter,1972,4413575.692000001,3933004.0,1.122189474508544,2,5,5,12,6,10,5,21,4.7580468684527994e-06,5.339430114996069e-06
213,Norway,NOR,Winter,1972,4413575.692000001,3933004.0,1.122189474508544,2,5,5,12,6,10,5,21,4.7580468684527994e-06,5.339430114996069e-06
214,New Zealand,NZL,Summer,1972,3294648.943,2903900.0,1.1345600547539516,1,1,1,3,3,2,1,6,1.821134847385772e-06,2.0661868521643307e-06
215,Pakistan,PAK,Summer,1972,150617.2113,62509565.0,0.0024095066299053593,0,1,0,1,0,2,0,2,1.3278694929601316e-05,3.199510346936505e-08
216,Poland,POL,Summer,1972,0.0,33055650.0,0.0,7,5,9,21,21,10,9,40,0.0,1.2100805762403705e-06
217,Poland,POL,Summer,1972,0.0,33055650.0,0.0,7,5,9,21,21,10,9,40,0.0,1.2100805762403705e-06
218,Poland,POL,Winter,1972,0.0,33055650.0,0.0,1,0,0,1,3,0,0,3,0.0,9.075604321802778e-08
219,Poland,POL,Winter,1972,0.0,33055650.0,0.0,1,0,0,1,3,0,0,3,0.0,9.075604321802778e-08
220,"Korea, Dem. People's Rep.",PRK,Summer,1972,0.0,15768363.0,0.0,1,1,3,5,3,2,3,8,0.0,5.073449919944131e-07
221,Romania,ROU,Summer,1972,0.0,20657957.0,0.0,3,6,7,16,9,12,7,28,0.0,1.3554099275160655e-06
222,Sweden,SWE,Summer,1972,6027128.499000001,8122300.0,0.7420470185784815,4,6,6,16,12,12,6,30,4.977494673454779e-06,3.693535082427391e-06
223,Sweden,SWE,Summer,1972,6027128.499000001,8122300.0,0.7420470185784815,4,6,6,16,12,12,6,30,4.977494673454779e-06,3.693535082427391e-06
224,Sweden,SWE,Winter,1972,6027128.499000001,8122300.0,0.7420470185784815,1,1,2,4,3,2,2,7,1.161415423806115e-06,8.618248525663913e-07
225,Sweden,SWE,Winter,1972,6027128.499000001,8122300.0,0.7420470185784815,1,1,2,4,3,2,2,7,1.161415423806115e-06,8.618248525663913e-07
226,Tunisia,TUN,Summer,1972,420566.5745,5320148.0,0.07905166820547098,0,1,0,1,0,2,0,2,4.755489668616068e-06,3.7592939143798255e-07
227,Turkiye,TUR,Summer,1972,547465.1976,37188035.0,0.014721541420513344,0,1,0,1,0,2,0,2,3.6532002559572385e-06,5.3780738885504435e-08
228,Uganda,UGA,Summer,1972,137025.2176,10885563.0,0.012587793355290857,1,1,0,2,3,2,0,5,3.6489633715422026e-05,4.593239688199866e-07
229,United States,USA,Summer,1972,6094017.99,209896000.0,0.02903351178678965,33,31,30,94,99,62,30,191,3.1342211380639527e-05,9.099744635438503e-07
230,United States,USA,Summer,1972,6094017.99,209896000.0,0.02903351178678965,33,31,30,94,99,62,30,191,3.1342211380639527e-05,9.099744635438503e-07
231,United States,USA,Winter,1972,6094017.99,209896000.0,0.02903351178678965,3,2,3,8,9,4,3,16,2.625525560681845e-06,7.622822731257385e-08
232,United States,USA,Winter,1972,6094017.99,209896000.0,0.02903351178678965,3,2,3,8,9,4,3,16,2.625525560681845e-06,7.622822731257385e-08
233,Australia,AUS,Summer,1976,7487078.975000001,14033000.0,0.5335337401125918,0,1,4,5,0,2,4,6,8.013806212054815e-07,4.275636000855127e-07
234,Austria,AUT,Summer,1976,5678386.658000001,7565525.0,0.7505608213574075,0,0,1,1,0,0,1,1,1.761063591171885e-07,1.3217853354525957e-07
235,Austria,AUT,Summer,1976,5678386.658000001,7565525.0,0.7505608213574075,0,0,1,1,0,0,1,1,1.761063591171885e-07,1.3217853354525957e-07
236,Austria,AUT,Winter,1976,5678386.658000001,7565525.0,0.7505608213574075,2,2,2,6,6,4,2,12,2.113276309406262e-06,1.586142402543115e-06
237,Austria,AUT,Winter,1976,5678386.658000001,7565525.0,0.7505608213574075,2,2,2,6,6,4,2,12,2.113276309406262e-06,1.586142402543115e-06
238,Belgium,BEL,Summer,1976,7243047.341,9818227.0,0.7377143898791503,0,3,3,6,0,6,3,9,1.2425709202609505e-06,9.166624483218813e-07
239,Brazil,BRA,Summer,1976,1376347.9279999998,111286504.0,0.01236760863653332,0,0,2,2,0,0,2,2,1.4531209437037058e-06,1.79716311332774e-08
240,Canada,CAN,Summer,1976,8809264.66,23449808.0,0.37566468177479323,0,5,6,11,0,10,6,16,1.8162696453712856e-06,6.823083583456205e-07
241,Canada,CAN,Summer,1976,8809264.66,23449808.0,0.37566468177479323,0,5,6,11,0,10,6,16,1.8162696453712856e-06,6.823083583456205e-07
242,Canada,CAN,Winter,1976,8809264.66,23449808.0,0.37566468177479323,1,1,1,3,3,2,1,6,6.811011170142321e-07,2.5586563437960773e-07
243,Canada,CAN,Winter,1976,8809264.66,23449808.0,0.37566468177479323,1,1,1,3,3,2,1,6,6.811011170142321e-07,2.5586563437960773e-07
244,Cuba,CUB,Summer,1976,1436285.607,9600862.0,0.14959965126048058,6,4,3,13,18,8,3,29,2.0190970276846893e-05,3.0205621120270243e-06
245,Spain,ESP,Summer,1976,3279312.671,36137812.0,0.09074463808157505,0,2,0,2,0,4,0,4,1.2197677993237016e-06,1.1068738749318858e-07
246,Finland,FIN,Summer,1976,6739690.7129999995,4725664.0,1.4261891478107627,4,2,0,6,12,4,0,16,2.373996178954926e-06,3.3857675873697325e-06
247,Finland,FIN,Summer,1976,6739690.7129999995,4725664.0,1.4261891478107627,4,2,0,6,12,4,0,16,2.373996178954926e-06,3.3857675873697325e-06
248,Finland,FIN,Winter,1976,6739690.7129999995,4725664.0,1.4261891478107627,2,4,1,7,6,8,1,15,2.225621417770243e-06,3.1741571131591242e-06
249,Finland,FIN,Winter,1976,6739690.7129999995,4725664.0,1.4261891478107627,2,4,1,7,6,8,1,15,2.225621417770243e-06,3.1741571131591242e-06
250,France,FRA,Summer,1976,6899069.578,53966558.0,0.12783971840486844,2,3,4,9,6,6,4,16,2.319153303080371e-06,2.964799052035151e-07
251,France,FRA,Summer,1976,6899069.578,53966558.0,0.12783971840486844,2,3,4,9,6,6,4,16,2.319153303080371e-06,2.964799052035151e-07
252,France,FRA,Winter,1976,6899069.578,53966558.0,0.12783971840486844,0,0,1,1,0,0,1,1,1.449470814425232e-07,1.8529994075219695e-08
253,France,FRA,Winter,1976,6899069.578,53966558.0,0.12783971840486844,0,0,1,1,0,0,1,1,1.449470814425232e-07,1.8529994075219695e-08
254,United Kingdom,GBR,Summer,1976,4138167.7879999997,56211968.0,0.07361720173184472,3,5,5,13,9,10,5,24,5.799668169472494e-06,4.2695534160981517e-07
255,United Kingdom,GBR,Summer,1976,4138167.7879999997,56211968.0,0.07361720173184472,3,5,5,13,9,10,5,24,5.799668169472494e-06,4.2695534160981517e-07
256,United Kingdom,GBR,Winter,1976,4138167.7879999997,56211968.0,0.07361720173184472,1,0,0,1,3,0,0,3,7.249585211840618e-07,5.3369417701226896e-08
257,United Kingdom,GBR,Winter,1976,4138167.7879999997,56211968.0,0.07361720173184472,1,0,0,1,3,0,0,3,7.249585211840618e-07,5.3369417701226896e-08
258,Hungary,HUN,Summer,1976,0.0,10598677.0,0.0,4,5,13,22,12,10,13,35,0.0,3.302298956747149e-06
259,Italy,ITA,Summer,1976,4033099.354,55718260.0,0.072383799386413,2,7,4,13,6,14,4,24,5.95075843499788e-06,4.307385047558915e-07
260,Italy,ITA,Summer,1976,4033099.354,55718260.0,0.072383799386413,2,7,4,13,6,14,4,24,5.95075843499788e-06,4.307385047558915e-07
261,Italy,ITA,Winter,1976,4033099.354,55718260.0,0.072383799386413,1,2,1,4,3,4,1,8,1.9835861449992936e-06,1.4357950158529718e-07
262,Italy,ITA,Winter,1976,4033099.354,55718260.0,0.072383799386413,1,2,1,4,3,4,1,8,1.9835861449992936e-06,1.4357950158529718e-07
263,Jamaica,JAM,Summer,1976,1461458.8269999998,2029486.0,0.7201127906277747,1,1,0,2,3,2,0,5,3.4212390439104726e-06,2.46367799531507e-06
264,Japan,JPN,Summer,1976,5197622.336999999,112775000.0,0.04608842684105519,9,6,10,25,27,12,10,49,9.427387528945047e-06,4.3449346043005983e-07
265,"Korea, Rep.",KOR,Summer,1976,834134.208,35848523.0,0.023268300565688578,1,1,4,6,3,2,4,9,1.0789630629799084e-05,2.510563684869248e-07
266,Liechtenstein,LIE,Winter,1976,11637080.59,23416.0,496.9713268705159,0,0,2,2,0,0,2,2,1.718644108831423e-07,8.541168431841476e-05
267,Mexico,MEX,Summer,1976,1472658.876,60452543.0,0.024360577784130602,1,0,1,2,3,0,1,4,2.7161755279435127e-06,6.616760522381994e-08
268,Norway,NOR,Summer,1976,8927201.627,4026152.0,2.217303675320753,1,1,0,2,3,2,0,5,5.600859271373103e-07,1.2418805847369896e-06
269,Norway,NOR,Summer,1976,8927201.627,4026152.0,2.217303675320753,1,1,0,2,3,2,0,5,5.600859271373103e-07,1.2418805847369896e-06
270,Norway,NOR,Winter,1976,8927201.627,4026152.0,2.217303675320753,3,3,1,7,9,6,1,16,1.792274966839393e-06,3.974017871158367e-06
271,Norway,NOR,Winter,1976,8927201.627,4026152.0,2.217303675320753,3,3,1,7,9,6,1,16,1.792274966839393e-06,3.974017871158367e-06
272,New Zealand,NZL,Summer,1976,4373840.998,3110500.0,1.4061536723999355,2,1,1,4,6,2,1,9,2.057687969022051e-06,2.893425494293522e-06
273,Pakistan,PAK,Summer,1976,187496.9066,70230923.0,0.0026697200975131707,0,0,1,1,0,0,1,1,5.3334213248294734e-06,1.4238742099402567e-08
274,Poland,POL,Summer,1976,0.0,34356300.0,0.0,7,6,13,26,21,12,13,46,0.0,1.3389101853226338e-06
275,"Korea, Dem. People's Rep.",PRK,Summer,1976,0.0,16987170.0,0.0,1,1,0,2,3,2,0,5,0.0,2.943397870275037e-07
276,Romania,ROU,Summer,1976,0.0,21551634.0,0.0,4,9,14,27,12,18,14,44,0.0,2.0416085388235527e-06
277,Sweden,SWE,Summer,1976,10868275.77,8222286.0,1.3218070704424536,4,1,0,5,12,2,0,14,1.288152812486097e-06,1.702689495354455e-06
278,Sweden,SWE,Summer,1976,10868275.77,8222286.0,1.3218070704424536,4,1,0,5,12,2,0,14,1.288152812486097e-06,1.702689495354455e-06
279,Sweden,SWE,Winter,1976,10868275.77,8222286.0,1.3218070704424536,0,0,2,2,0,0,2,2,1.840218303551567e-07,2.432413564792078e-07
280,Sweden,SWE,Winter,1976,10868275.77,8222286.0,1.3218070704424536,0,0,2,2,0,0,2,2,1.840218303551567e-07,2.432413564792078e-07
281,Thailand,THA,Summer,1976,405547.9499,41882128.0,0.00968307889942937,0,0,1,1,0,0,1,1,2.4657996674538237e-06,2.387653273014208e-08
282,Trinidad and Tobago,TTO,Summer,1976,2341875.013,1067696.0,2.1933912021773985,1,0,0,1,3,0,0,3,1.2810248127447784e-06,2.8097885540453463e-06
283,United States,USA,Summer,1976,8592253.537,218035000.0,0.039407680129337035,34,35,25,94,102,70,25,197,2.2927628840522188e-05,9.03524663471461e-07
284,United States,USA,Summer,1976,8592253.537,218035000.0,0.039407680129337035,34,35,25,94,102,70,25,197,2.2927628840522188e-05,9.03524663471461e-07
285,United States,USA,Winter,1976,8592253.537,218035000.0,0.039407680129337035,3,3,4,10,9,6,4,19,2.2112941521315818e-06,8.714197261907492e-08
286,United States,USA,Winter,1976,8592253.537,218035000.0,0.039407680129337035,3,3,4,10,9,6,4,19,2.2112941521315818e-06,8.714197261907492e-08
287,"Venezuela, RB",VEN,Summer,1976,2316030.922,13566112.0,0.17072178985401268,0,1,0,1,0,2,0,2,8.635463287652945e-07,1.4742617486867277e-07
288,Australia,AUS,Summer,1980,10208576.17,14692000.0,0.6948391076776477,2,2,5,9,6,4,5,15,1.4693528020176392e-06,1.0209637898175878e-06
289,Austria,AUT,Summer,1980,10869546.49,7549433.0,1.4397831585497878,1,2,1,4,3,4,1,8,7.360012680713048e-07,1.0596822304403522e-06
290,Austria,AUT,Summer,1980,10869546.49,7549433.0,1.4397831585497878,1,2,1,4,3,4,1,8,7.360012680713048e-07,1.0596822304403522e-06
291,Austria,AUT,Winter,1980,10869546.49,7549433.0,1.4397831585497878,3,2,2,7,9,4,2,15,1.3800023776336964e-06,1.9869041820756605e-06
292,Austria,AUT,Winter,1980,10869546.49,7549433.0,1.4397831585497878,3,2,2,7,9,4,2,15,1.3800023776336964e-06,1.9869041820756605e-06
293,Belgium,BEL,Summer,1980,12864002.57,9859242.0,1.3047658805818947,1,0,0,1,3,0,0,3,2.3320890863285952e-07,3.0428302703189555e-07
294,Brazil,BRA,Summer,1980,1941259.538,122288383.0,0.01587443950420049,2,0,2,4,6,0,2,8,4.121035772600542e-06,6.541913306679344e-08
295,Canada,CAN,Winter,1980,11170563.969999999,24515667.0,0.45565001229621854,0,1,1,2,0,2,1,3,2.685629846493776e-07,1.2237072725779804e-07
296,Cuba,CUB,Summer,1980,2030041.0489999999,9809107.0,0.20695472574618667,8,7,5,20,24,14,5,43,2.1181837688051598e-05,4.383681409530959e-06
297,Spain,ESP,Summer,1980,6208578.018999999,37491165.0,0.1656010961249137,1,3,2,6,3,6,2,11,1.7717422518227038e-06,2.934024589526626e-07
298,Ethiopia,ETH,Summer,1980,0.0,34945469.0,0.0,2,0,2,4,6,0,2,8,0.0,2.2892810509997734e-07
299,Finland,FIN,Summer,1980,11223937.56,4779535.0,2.3483325386256197,3,1,4,8,9,2,4,15,1.3364293876203638e-06,3.1383806165244107e-06
300,Finland,FIN,Summer,1980,11223937.56,4779535.0,2.3483325386256197,3,1,4,8,9,2,4,15,1.3364293876203638e-06,3.1383806165244107e-06
301,Finland,FIN,Winter,1980,11223937.56,4779535.0,2.3483325386256197,1,5,3,9,3,10,3,16,1.4255246801283879e-06,3.3476059909593714e-06
302,Finland,FIN,Winter,1980,11223937.56,4779535.0,2.3483325386256197,1,5,3,9,3,10,3,16,1.4255246801283879e-06,3.3476059909593714e-06
303,France,FRA,Summer,1980,12738520.049999999,55052582.0,0.23138823988309937,6,5,3,14,18,10,3,31,2.433563701145959e-06,5.630980214515643e-07
304,France,FRA,Summer,1980,12738520.049999999,55052582.0,0.23138823988309937,6,5,3,14,18,10,3,31,2.433563701145959e-06,5.630980214515643e-07
305,France,FRA,Winter,1980,12738520.049999999,55052582.0,0.23138823988309937,0,0,1,1,0,0,1,1,7.850205487567609e-08,1.816445230488917e-08
306,France,FRA,Winter,1980,12738520.049999999,55052582.0,0.23138823988309937,0,0,1,1,0,0,1,1,7.850205487567609e-08,1.816445230488917e-08
307,United Kingdom,GBR,Summer,1980,10032062.08,56314216.0,0.1781443974999137,5,7,9,21,15,14,9,38,3.787855347880782e-06,6.747852087650479e-07
308,United Kingdom,GBR,Summer,1980,10032062.08,56314216.0,0.1781443974999137,5,7,9,21,15,14,9,38,3.787855347880782e-06,6.747852087650479e-07
309,United Kingdom,GBR,Winter,1980,10032062.08,56314216.0,0.1781443974999137,1,0,0,1,3,0,0,3,2.9904121167479855e-07,5.3272516481451146e-08
310,United Kingdom,GBR,Winter,1980,10032062.08,56314216.0,0.1781443974999137,1,0,0,1,3,0,0,3,2.9904121167479855e-07,5.3272516481451146e-08
311,Guyana,GUY,Summer,1980,775145.9824,778176.0,0.9961062566822929,0,0,1,1,0,0,1,1,1.290079575596598e-06,1.2850563368698084e-06
312,Hungary,HUN,Summer,1980,0.0,10711122.0,0.0,7,10,15,32,21,20,15,56,0.0,5.228210452649125e-06
313,Hungary,HUN,Summer,1980,0.0,10711122.0,0.0,7,10,15,32,21,20,15,56,0.0,5.228210452649125e-06
314,Hungary,HUN,Winter,1980,0.0,10711122.0,0.0,0,1,0,1,0,2,0,2,0.0,1.8672180188032588e-07
315,Hungary,HUN,Winter,1980,0.0,10711122.0,0.0,0,1,0,1,0,2,0,2,0.0,1.8672180188032588e-07
316,India,IND,Summer,1980,267390.5787,696828385.0,0.0003837251530733783,1,0,0,1,3,0,0,3,1.1219542642771504e-05,4.305220718010791e-09
317,Ireland,IRL,Summer,1980,6372437.775,3412800.0,1.867216882032349,0,1,1,2,0,2,1,3,4.7077744905873167e-07,8.790436005625879e-07
318,Italy,ITA,Summer,1980,8456918.974,56433883.0,0.14985534442136472,8,3,4,15,24,6,4,34,4.0203767003715885e-06,6.024749351378142e-07
319,Italy,ITA,Summer,1980,8456918.974,56433883.0,0.14985534442136472,8,3,4,15,24,6,4,34,4.0203767003715885e-06,6.024749351378142e-07
320,Italy,ITA,Winter,1980,8456918.974,56433883.0,0.14985534442136472,0,2,0,2,0,4,0,4,4.729854941613634e-07,7.08794041338605e-08
321,Italy,ITA,Winter,1980,8456918.974,56433883.0,0.14985534442136472,0,2,0,2,0,4,0,4,4.729854941613634e-07,7.08794041338605e-08
322,Jamaica,JAM,Summer,1980,1254671.851,2135546.0,0.5875180637644892,0,0,3,3,0,0,3,3,2.3910634462779543e-06,1.4047929662952706e-06
323,Japan,JPN,Winter,1980,9463353.854999999,116807000.0,0.08101700972544452,0,1,0,1,0,2,0,2,2.1134156353492928e-07,1.7122261508300015e-08
324,Lebanon,LBN,Summer,1980,0.0,2963702.0,0.0,0,0,1,1,0,0,1,1,0.0,3.374158400540945e-07
325,Liechtenstein,LIE,Winter,1980,21385510.36,25003.0,855.317776266848,2,2,0,4,6,4,0,10,4.6760632931651955e-07,0.0003999520057593089
326,Mexico,MEX,Summer,1980,3029887.355,67705186.0,0.04475118575111809,0,1,3,4,0,2,3,5,1.6502263662538041e-06,7.384958664761663e-08
327,Norway,NOR,Winter,1980,15772240.91,4085620.0,3.860427771060451,1,3,6,10,3,6,6,15,9.51037971433065e-07,3.6714133962532e-06
328,Poland,POL,Summer,1980,0.0,35574150.0,0.0,3,14,15,32,9,28,15,52,0.0,1.4617355579824113e-06
329,"Korea, Dem. People's Rep.",PRK,Summer,1980,0.0,17973650.0,0.0,0,3,2,5,0,6,2,8,0.0,4.4509601555610575e-07
330,Romania,ROU,Summer,1980,0.0,22207282.0,0.0,6,6,13,25,18,12,13,43,0.0,1.9363017950598368e-06
331,Sweden,SWE,Summer,1980,17097832.65,8310531.0,2.0573694568975194,3,3,6,12,9,6,6,21,1.2282258476778343e-06,2.526914345184441e-06
332,Sweden,SWE,Summer,1980,17097832.65,8310531.0,2.0573694568975194,3,3,6,12,9,6,6,21,1.2282258476778343e-06,2.526914345184441e-06
333,Sweden,SWE,Winter,1980,17097832.65,8310531.0,2.0573694568975194,3,0,1,4,9,0,1,10,5.848694512751592e-07,1.2032925453259245e-06
334,Sweden,SWE,Winter,1980,17097832.65,8310531.0,2.0573694568975194,3,0,1,4,9,0,1,10,5.848694512751592e-07,1.2032925453259245e-06
335,Uganda,UGA,Summer,1980,93692.22855,13284026.0,0.007052999485999199,0,1,0,1,0,2,0,2,2.134648765380445e-05,1.5055676645017105e-07
336,United States,USA,Winter,1980,12574791.51,227225000.0,0.055340704191880294,6,4,2,12,18,8,2,28,2.226677076731907e-06,1.232258774342612e-07
337,"Venezuela, RB",VEN,Summer,1980,3886573.9560000002,15210443.0,0.2555201026031918,0,1,0,1,0,2,0,2,5.145920346922635e-07,1.314886095033524e-07
338,Australia,AUS,Summer,1984,12421492.6,15579391.0,0.7973028342378723,4,8,12,24,12,16,12,40,3.2202249188636154e-06,2.5674944546933833e-06
339,Austria,AUT,Summer,1984,8991065.04,7561434.0,1.1890687718758108,1,1,1,3,3,2,1,6,6.673291732744489e-07,7.935002805023492e-07
340,Austria,AUT,Summer,1984,8991065.04,7561434.0,1.1890687718758108,1,1,1,3,3,2,1,6,6.673291732744489e-07,7.935002805023492e-07
341,Austria,AUT,Winter,1984,8991065.04,7561434.0,1.1890687718758108,0,0,1,1,0,0,1,1,1.1122152887907484e-07,1.3225004675039153e-07
342,Austria,AUT,Winter,1984,8991065.04,7561434.0,1.1890687718758108,0,0,1,1,0,0,1,1,1.1122152887907484e-07,1.3225004675039153e-07
343,Belgium,BEL,Summer,1984,8457268.803000001,9855372.0,0.8581379579583603,1,1,2,4,3,2,2,7,8.276903765334889e-07,7.102725295402345e-07
344,Brazil,BRA,Summer,1984,1406689.8,133888775.0,0.010506405783457202,1,5,2,8,3,10,2,15,1.0663331745207791e-05,1.1203329031877393e-07
345,Canada,CAN,Summer,1984,13877917.08,25607053.0,0.5419568225988364,10,18,16,44,30,36,16,82,5.908667671618629e-06,3.2022427571028967e-06
346,Canada,CAN,Summer,1984,13877917.08,25607053.0,0.5419568225988364,10,18,16,44,30,36,16,82,5.908667671618629e-06,3.2022427571028967e-06
347,Canada,CAN,Winter,1984,13877917.08,25607053.0,0.5419568225988364,2,1,1,4,6,2,1,9,6.485123054215568e-07,3.5146566846251304e-07
348,Canada,CAN,Winter,1984,13877917.08,25607053.0,0.5419568225988364,2,1,1,4,6,2,1,9,6.485123054215568e-07,3.5146566846251304e-07
349,China,CHN,Summer,1984,250713.96899999998,1036825000.0,0.00024180934005256432,15,8,9,32,45,16,9,70,0.00027920263190440737,6.751380416174378e-08
350,Cote d'Ivoire,CIV,Summer,1984,711085.2016,9621405.0,0.07390658657441403,0,1,0,1,0,2,0,2,2.812602477874432e-06,2.0786984853043813e-07
351,Cameroon,CMR,Summer,1984,768983.9227,9508570.0,0.08087272036699525,0,0,1,1,0,0,1,1,1.3004173045502347e-06,1.0516828503129282e-07
352,Colombia,COL,Summer,1984,1333370.911,28689032.0,0.046476678299916155,0,1,0,1,0,2,0,2,1.4999577263164098e-06,6.971305270948145e-08
353,Dominican Republic,DOM,Summer,1984,1845560.023,6282104.0,0.29378055871090325,0,0,1,1,0,0,1,1,5.418409520891534e-07,1.5918233763719926e-07
354,"Egypt, Arab Rep.",EGY,Summer,1984,697897.9336999999,48676443.0,0.014337488334963176,0,1,0,1,0,2,0,2,2.8657485621095486e-06,4.108763658018315e-08
355,Spain,ESP,Summer,1984,4489988.939,38330364.0,0.1171392199406194,1,2,2,5,3,4,2,9,2.004459280918509e-06,2.3480079656952906e-07
356,Finland,FIN,Summer,1984,10833866.29,4881803.0,2.219234633187779,4,2,6,12,12,4,6,22,2.030669329960874e-06,4.5065317056013935e-06
357,Finland,FIN,Summer,1984,10833866.29,4881803.0,2.219234633187779,4,2,6,12,12,4,6,22,2.030669329960874e-06,4.5065317056013935e-06
358,Finland,FIN,Winter,1984,10833866.29,4881803.0,2.219234633187779,4,3,6,13,12,6,6,24,2.21527563268459e-06,4.9162164061106115e-06
359,Finland,FIN,Winter,1984,10833866.29,4881803.0,2.219234633187779,4,3,6,13,12,6,6,24,2.21527563268459e-06,4.9162164061106115e-06
360,France,FRA,Summer,1984,9430069.648,56275701.0,0.16756911918342873,5,7,16,28,15,14,16,45,4.771968997020498e-06,7.996346416013548e-07
361,France,FRA,Summer,1984,9430069.648,56275701.0,0.16756911918342873,5,7,16,28,15,14,16,45,4.771968997020498e-06,7.996346416013548e-07
362,France,FRA,Winter,1984,9430069.648,56275701.0,0.16756911918342873,0,1,2,3,0,2,2,4,4.241750219573776e-07,7.107863480900931e-08
363,France,FRA,Winter,1984,9430069.648,56275701.0,0.16756911918342873,0,1,2,3,0,2,2,4,4.241750219573776e-07,7.107863480900931e-08
364,United Kingdom,GBR,Summer,1984,8179194.441,56422072.0,0.14496444655559618,5,11,21,37,15,22,21,58,7.091162878982596e-06,1.0279665021873001e-06
365,United Kingdom,GBR,Summer,1984,8179194.441,56422072.0,0.14496444655559618,5,11,21,37,15,22,21,58,7.091162878982596e-06,1.0279665021873001e-06
366,United Kingdom,GBR,Winter,1984,8179194.441,56422072.0,0.14496444655559618,1,0,0,1,3,0,0,3,3.6678428684392734e-07,5.3170681147618964e-08
367,United Kingdom,GBR,Winter,1984,8179194.441,56422072.0,0.14496444655559618,1,0,0,1,3,0,0,3,3.6678428684392734e-07,5.3170681147618964e-08
368,Ireland,IRL,Summer,1984,5692027.386,3532423.0,1.6113663018273858,0,1,0,1,0,2,0,2,3.5136865379797035e-07,5.661836082485025e-07
369,Iceland,ISL,Summer,1984,11959540.01,239511.0,49.93315551269044,0,0,1,1,0,0,1,1,8.361525603525281e-08,4.175173582841706e-06
370,Italy,ITA,Summer,1984,7739715.284,56576718.0,0.13680035812611116,14,6,12,32,42,12,12,66,8.527445465137345e-06,1.1665575935316716e-06
371,Italy,ITA,Summer,1984,7739715.284,56576718.0,0.13680035812611116,14,6,12,32,42,12,12,66,8.527445465137345e-06,1.1665575935316716e-06
372,Italy,ITA,Winter,1984,7739715.284,56576718.0,0.13680035812611116,2,0,0,2,6,0,0,6,7.75222315012486e-07,1.0605069032106104e-07
373,Italy,ITA,Winter,1984,7739715.284,56576718.0,0.13680035812611116,2,0,0,2,6,0,0,6,7.75222315012486e-07,1.0605069032106104e-07
374,Jamaica,JAM,Summer,1984,1048351.3089999999,2264095.0,0.46303326892201957,0,1,2,3,0,2,2,4,3.815514861917342e-06,1.7667103191341353e-06
375,Japan,JPN,Summer,1984,10978919.809999999,120083000.0,0.09142776088205656,10,8,14,32,30,16,14,60,5.465018511689084e-06,4.996544057027223e-07
376,Japan,JPN,Summer,1984,10978919.809999999,120083000.0,0.09142776088205656,10,8,14,32,30,16,14,60,5.465018511689084e-06,4.996544057027223e-07
377,Japan,JPN,Winter,1984,10978919.809999999,120083000.0,0.09142776088205656,0,1,0,1,0,2,0,2,1.8216728372296947e-07,1.665514685675741e-08
378,Japan,JPN,Winter,1984,10978919.809999999,120083000.0,0.09142776088205656,0,1,0,1,0,2,0,2,1.8216728372296947e-07,1.665514685675741e-08
379,Kenya,KEN,Summer,1984,330154.05340000003,18753176.0,0.017605234089415042,1,0,2,3,3,0,2,5,1.5144445293065117e-05,2.666215045387512e-07
380,"Korea, Rep.",KOR,Summer,1984,2413263.9250000003,40405956.0,0.05972545050041633,6,6,7,19,18,12,7,37,1.5331932664596557e-05,9.15706585435078e-07
381,Liechtenstein,LIE,Winter,1984,19024123.97,26420.0,720.0652524602573,0,0,2,2,0,0,2,2,1.0512967657033198e-07,7.57002271006813e-05
382,Morocco,MAR,Summer,1984,675019.2871000001,21817271.0,0.030939675594624096,2,0,0,2,6,0,0,6,8.888634909643901e-06,2.7501148058343316e-07
383,Mexico,MEX,Summer,1984,2507312.061,73489654.0,0.03411789176473739,2,3,1,6,6,6,1,13,5.184835267300219e-06,1.7689564846774215e-07
384,Norway,NOR,Summer,1984,14989485.77,4140099.0,3.6205621580546743,0,1,2,3,0,2,2,4,2.6685371742409015e-07,9.66160471041876e-07
385,Norway,NOR,Summer,1984,14989485.77,4140099.0,3.6205621580546743,0,1,2,3,0,2,2,4,2.6685371742409015e-07,9.66160471041876e-07
386,Norway,NOR,Winter,1984,14989485.77,4140099.0,3.6205621580546743,3,2,4,9,9,4,4,17,1.134128299052383e-06,4.106182001927973e-06
387,Norway,NOR,Winter,1984,14989485.77,4140099.0,3.6205621580546743,3,2,4,9,9,4,4,17,1.134128299052383e-06,4.106182001927973e-06
388,New Zealand,NZL,Summer,1984,6713760.131,3227100.0,2.080431387623563,8,1,2,11,24,2,2,28,4.170539228935703e-06,8.676520715193208e-06
389,Pakistan,PAK,Summer,1984,331388.7658,94003867.0,0.003525267378628158,1,0,0,1,3,0,0,3,9.052811409456658e-06,3.191358074663035e-08
390,Peru,PER,Summer,1984,911789.2245,19285646.0,0.04727812718847997,0,1,0,1,0,2,0,2,2.193489401124196e-06,1.037040708929325e-07
391,Romania,ROU,Summer,1984,0.0,22640547.0,0.0,20,16,17,53,60,32,17,109,0.0,4.814371313555278e-06
392,Sweden,SWE,Summer,1984,13099020.83,8336605.0,1.5712656207173064,2,11,6,19,6,22,6,34,2.5956138585665565e-06,4.078398820623023e-06
393,Sweden,SWE,Summer,1984,13099020.83,8336605.0,1.5712656207173064,2,11,6,19,6,22,6,34,2.5956138585665565e-06,4.078398820623023e-06
394,Sweden,SWE,Winter,1984,13099020.83,8336605.0,1.5712656207173064,4,2,2,8,12,4,2,18,1.3741485133587653e-06,2.159152316800424e-06
395,Sweden,SWE,Winter,1984,13099020.83,8336605.0,1.5712656207173064,4,2,2,8,12,4,2,18,1.3741485133587653e-06,2.159152316800424e-06
396,Syrian Arab Republic,SYR,Summer,1984,1885019.531,10183138.0,0.18511185167087002,0,1,0,1,0,2,0,2,1.0609969642802602e-06,1.9640311267509092e-07
397,Thailand,THA,Summer,1984,842069.9352000001,49636724.0,0.016964655749642142,0,1,0,1,0,2,0,2,2.3750996400613446e-06,4.029274776473967e-08
398,Turkiye,TUR,Summer,1984,1247016.105,48106764.0,0.025921845522596364,0,0,3,3,0,0,3,3,2.4057427870989686e-06,6.23612928942799e-08
399,United States,USA,Summer,1984,17121225.48,235825000.0,0.07260140137814057,83,61,30,174,249,122,30,401,2.342122066369749e-05,1.7004134421711014e-06
400,United States,USA,Summer,1984,17121225.48,235825000.0,0.07260140137814057,83,61,30,174,249,122,30,401,2.342122066369749e-05,1.7004134421711014e-06
401,United States,USA,Winter,1984,17121225.48,235825000.0,0.07260140137814057,4,4,0,8,12,8,0,20,1.1681406814811716e-06,8.48086504823492e-08
402,United States,USA,Winter,1984,17121225.48,235825000.0,0.07260140137814057,4,4,0,8,12,8,0,20,1.1681406814811716e-06,8.48086504823492e-08
403,"Venezuela, RB",VEN,Summer,1984,3539754.463,16953234.0,0.20879523417184,0,0,3,3,0,0,3,3,8.475164114794139e-07,1.7695738759932175e-07
404,Argentina,ARG,Summer,1988,3982444.4020000002,31690792.0,0.12566566345202101,0,1,1,2,0,2,1,3,7.533061851393048e-07,9.466472153804171e-08
405,Australia,AUS,Summer,1988,14284515.81,16532164.0,0.8640439212918527,3,6,5,14,9,12,5,26,1.8201526986163908e-06,1.572691875062454e-06
406,Austria,AUT,Summer,1988,17578618.94,7585317.0,2.3174534353673026,1,0,0,1,3,0,0,3,1.7066187111966601e-07,3.955009395124818e-07
407,Austria,AUT,Summer,1988,17578618.94,7585317.0,2.3174534353673026,1,0,0,1,3,0,0,3,1.7066187111966601e-07,3.955009395124818e-07
408,Austria,AUT,Winter,1988,17578618.94,7585317.0,2.3174534353673026,3,5,2,10,9,10,2,21,1.194633097837662e-06,2.768506576587373e-06
409,Austria,AUT,Winter,1988,17578618.94,7585317.0,2.3174534353673026,3,5,2,10,9,10,2,21,1.194633097837662e-06,2.768506576587373e-06
410,Belgium,BEL,Summer,1988,16391093.830000002,9901664.0,1.6553878045144736,0,0,2,2,0,0,2,2,1.2201748222192928e-07,2.0198625200774334e-07
411,Brazil,BRA,Summer,1988,1781817.8760000002,145253973.0,0.012266913181094194,1,2,3,6,3,4,3,10,5.61224586120383e-06,6.88449327303426e-08
412,Canada,CAN,Summer,1988,18936964.1,26791747.0,0.7068208019432254,3,2,5,10,9,4,5,18,9.505219477075525e-07,6.718486853432888e-07
413,Canada,CAN,Summer,1988,18936964.1,26791747.0,0.7068208019432254,3,2,5,10,9,4,5,18,9.505219477075525e-07,6.718486853432888e-07
414,Canada,CAN,Winter,1988,18936964.1,26791747.0,0.7068208019432254,0,2,3,5,0,4,3,7,3.6964742410849264e-07,2.612744887446123e-07
415,Canada,CAN,Winter,1988,18936964.1,26791747.0,0.7068208019432254,0,2,3,5,0,4,3,7,3.6964742410849264e-07,2.612744887446123e-07
416,Channel Islands,CHI,Summer,1988,0.0,137765.0,0.0,0,1,0,1,0,2,0,2,0.0,1.4517475411026022e-05
417,China,CHN,Summer,1988,283537.69519999996,1101630000.0,0.00025738015050425276,5,11,12,28,15,22,12,49,0.00017281652785333077,4.447954394851266e-08
418,Colombia,COL,Summer,1988,1254531.5459999999,31256727.0,0.040136369556543774,0,0,1,1,0,0,1,1,7.971102864558817e-07,3.199311303451574e-08
419,Djibouti,DJI,Summer,1988,820576.7723000001,482337.0,1.7012519717541885,0,0,1,1,0,0,1,1,1.2186550165161187e-06,2.0732392497361803e-06
420,Spain,ESP,Summer,1988,9703123.838,38766939.0,0.25029378352518367,1,1,2,4,3,2,2,7,7.214171556366362e-07,1.8056622938426993e-07
421,Finland,FIN,Summer,1988,22047793.32,4946481.0,4.4572683732132,1,1,2,4,3,2,2,7,3.17492090859277e-07,1.4151474553323868e-06
422,Finland,FIN,Summer,1988,22047793.32,4946481.0,4.4572683732132,1,1,2,4,3,2,2,7,3.17492090859277e-07,1.4151474553323868e-06
423,Finland,FIN,Winter,1988,22047793.32,4946481.0,4.4572683732132,4,1,2,7,12,2,2,16,7.256962076783474e-07,3.2346227550454556e-06
424,Finland,FIN,Winter,1988,22047793.32,4946481.0,4.4572683732132,4,1,2,7,12,2,2,16,7.256962076783474e-07,3.2346227550454556e-06
425,France,FRA,Summer,1988,17727510.83,57472651.0,0.3084512463153996,6,4,6,16,18,8,6,32,1.8051039599900785e-06,5.56786566187803e-07
426,France,FRA,Summer,1988,17727510.83,57472651.0,0.3084512463153996,6,4,6,16,18,8,6,32,1.8051039599900785e-06,5.56786566187803e-07
427,France,FRA,Winter,1988,17727510.83,57472651.0,0.3084512463153996,1,0,1,2,3,0,1,4,2.2563799499875982e-07,6.959832077347537e-08
428,France,FRA,Winter,1988,17727510.83,57472651.0,0.3084512463153996,1,0,1,2,3,0,1,4,2.2563799499875982e-07,6.959832077347537e-08
429,United Kingdom,GBR,Summer,1988,15987168.08,56928327.0,0.2808297542276273,5,10,9,24,15,20,9,44,2.7522072564586435e-06,7.729016874147733e-07
430,Hungary,HUN,Summer,1988,0.0,10596487.0,0.0,11,6,6,23,33,12,6,51,0.0,4.812915827670057e-06
431,Italy,ITA,Summer,1988,15744661.260000002,56629288.0,0.2780303587783057,6,4,4,14,18,8,4,30,1.9054077762991515e-06,5.297612076634268e-07
432,Italy,ITA,Summer,1988,15744661.260000002,56629288.0,0.2780303587783057,6,4,4,14,18,8,4,30,1.9054077762991515e-06,5.297612076634268e-07
433,Italy,ITA,Winter,1988,15744661.260000002,56629288.0,0.2780303587783057,2,1,2,5,6,2,2,10,6.351359254330505e-07,1.7658706922114225e-07
434,Italy,ITA,Winter,1988,15744661.260000002,56629288.0,0.2780303587783057,2,1,2,5,6,2,2,10,6.351359254330505e-07,1.7658706922114225e-07
435,Jamaica,JAM,Summer,1988,1625744.27,2354805.0,0.6903944360573381,0,2,0,2,0,4,0,4,2.4604115627607288e-06,1.6986544533411472e-06
436,Japan,JPN,Summer,1988,25059007.43,122578000.0,0.20443315627600384,4,3,7,14,12,6,7,25,9.97645260684613e-07,2.0395176948555206e-07
437,Japan,JPN,Summer,1988,25059007.43,122578000.0,0.20443315627600384,4,3,7,14,12,6,7,25,9.97645260684613e-07,2.0395176948555206e-07
438,Japan,JPN,Winter,1988,25059007.43,122578000.0,0.20443315627600384,0,0,1,1,0,0,1,1,3.9905810427384515e-08,8.158070779422083e-09
439,Japan,JPN,Winter,1988,25059007.43,122578000.0,0.20443315627600384,0,0,1,1,0,0,1,1,3.9905810427384515e-08,8.158070779422083e-09
440,Kenya,KEN,Summer,1988,386355.9486,21626122.0,0.01786524410617863,5,2,2,9,15,4,2,21,5.435402269874615e-05,9.71047883665874e-07
441,"Korea, Rep.",KOR,Summer,1988,4748629.608,42031247.0,0.11297855635832076,12,10,11,33,36,20,11,67,1.4109333751178515e-05,1.594052158385879e-06
442,Liechtenstein,LIE,Winter,1988,41574494.379999995,27944.0,1487.7789285714284,0,0,1,1,0,0,1,1,2.4053208942477586e-08,3.5785857429144e-05
443,Morocco,MAR,Summer,1988,1076092.773,23720590.0,0.045365346013737436,1,0,2,3,3,0,2,5,4.64643953147337e-06,2.107873370771975e-07
444,Mexico,MEX,Summer,1988,2302027.017,78892015.0,0.029179467871368225,0,0,2,2,0,0,2,2,8.687995341628955e-07,2.535110809376589e-08
445,Norway,NOR,Summer,1988,24207281.470000003,4209488.0,5.750647458788338,2,3,0,5,6,6,0,12,4.957186132144396e-07,2.8507029833556954e-06
446,Norway,NOR,Summer,1988,24207281.470000003,4209488.0,5.750647458788338,2,3,0,5,6,6,0,12,4.957186132144396e-07,2.8507029833556954e-06
447,Norway,NOR,Winter,1988,24207281.470000003,4209488.0,5.750647458788338,0,3,2,5,0,6,2,8,3.30479075476293e-07,1.9004686555704637e-06
448,Norway,NOR,Winter,1988,24207281.470000003,4209488.0,5.750647458788338,0,3,2,5,0,6,2,8,3.30479075476293e-07,1.9004686555704637e-06
449,New Zealand,NZL,Summer,1988,13759155.629999999,3283400.0,4.190520688920022,3,2,8,13,9,4,8,21,1.5262564480492036e-06,6.395809222147774e-06
450,Pakistan,PAK,Summer,1988,356335.2154,107967838.0,0.0033003829844217127,0,0,1,1,0,0,1,1,2.8063462626826302e-06,9.262017453753218e-09
451,Peru,PER,Summer,1988,730209.7626,21143799.0,0.03453540977191469,0,1,0,1,0,2,0,2,2.738939004155133e-06,9.459038084877746e-08
452,Poland,POL,Summer,1988,0.0,37824487.0,0.0,2,5,9,16,6,10,9,25,0.0,6.609474967895797e-07
453,Romania,ROU,Summer,1988,1769889.9309999999,23057662.0,0.07675929723490611,7,11,6,24,21,22,6,49,2.7685337456162975e-05,2.1251070468462936e-06
454,Senegal,SEN,Summer,1988,902269.9219,7113636.0,0.12683667282104397,0,1,0,1,0,2,0,2,2.2166315771542068e-06,2.811501741163028e-07
455,Suriname,SUR,Summer,1988,2887061.4390000002,402139.0,7.179262491327626,1,0,0,1,3,0,0,3,1.0391188630329664e-06,7.460107077403584e-06
456,Sweden,SWE,Summer,1988,24534693.82,8436489.0,2.9081640265280972,0,4,7,11,0,8,7,15,6.113791396806598e-07,1.7779908205889915e-06
457,Sweden,SWE,Summer,1988,24534693.82,8436489.0,2.9081640265280972,0,4,7,11,0,8,7,15,6.113791396806598e-07,1.7779908205889915e-06
458,Sweden,SWE,Winter,1988,24534693.82,8436489.0,2.9081640265280972,4,0,2,6,12,0,2,14,5.706205303686157e-07,1.659458099216392e-06
459,Sweden,SWE,Winter,1988,24534693.82,8436489.0,2.9081640265280972,4,0,2,6,12,0,2,14,5.706205303686157e-07,1.659458099216392e-06
460,Thailand,THA,Summer,1988,1154579.398,53410965.0,0.02161689829045403,0,0,1,1,0,0,1,1,8.66116268601564e-07,1.872274728606757e-08
461,Turkiye,TUR,Summer,1988,1737948.68,52275890.0,0.03324570236872103,1,1,0,2,3,2,0,5,2.8769549167585316e-06,9.564638689078273e-08
462,United States,USA,Summer,1988,21417011.93,244499000.0,0.08759549908179584,36,31,27,94,108,62,27,197,9.198295291793304e-06,8.057292667863672e-07
463,United States,USA,Summer,1988,21417011.93,244499000.0,0.08759549908179584,36,31,27,94,108,62,27,197,9.198295291793304e-06,8.057292667863672e-07
464,United States,USA,Winter,1988,21417011.93,244499000.0,0.08759549908179584,2,1,3,6,6,2,3,11,5.13610397003687e-07,4.498995905913726e-08
465,United States,USA,Winter,1988,21417011.93,244499000.0,0.08759549908179584,2,1,3,6,6,2,3,11,5.13610397003687e-07,4.498995905913726e-08
466,Argentina,ARG,Summer,1992,6815618.29,33568285.0,0.20303742922821347,0,0,1,1,0,0,1,1,1.467218317474173e-07,2.9790023529650084e-08
467,Australia,AUS,Summer,1992,18624555.08,17478635.0,1.0655611882735694,7,9,11,27,21,18,11,50,2.6846278896451362e-06,2.860635284162636e-06
468,Austria,AUT,Summer,1992,24880164.12,7840709.0,3.1732033569923335,0,2,0,2,0,4,0,4,1.6077064366245828e-07,5.101579461755308e-07
469,Austria,AUT,Summer,1992,24880164.12,7840709.0,3.1732033569923335,0,2,0,2,0,4,0,4,1.6077064366245828e-07,5.101579461755308e-07
470,Austria,AUT,Winter,1992,24880164.12,7840709.0,3.1732033569923335,6,7,8,21,18,14,8,40,1.6077064366245827e-06,5.101579461755308e-06
471,Austria,AUT,Winter,1992,24880164.12,7840709.0,3.1732033569923335,6,7,8,21,18,14,8,40,1.6077064366245827e-06,5.101579461755308e-06
472,Belgium,BEL,Summer,1992,23372619.17,10045158.0,2.326754757864436,0,1,2,3,0,2,2,4,1.7114042593626873e-07,3.982018003101594e-07
473,Brazil,BRA,Summer,1992,2105107.7479999997,155900790.0,0.013502867740439286,2,1,0,3,6,2,0,8,3.800280535569052e-06,5.1314685448354685e-08
474,Canada,CAN,Summer,1992,20879848.330000002,28371264.0,0.7359505847183968,7,4,7,18,21,8,7,36,1.724150455071816e-06,1.268889535552593e-06
475,Canada,CAN,Summer,1992,20879848.330000002,28371264.0,0.7359505847183968,7,4,7,18,21,8,7,36,1.724150455071816e-06,1.268889535552593e-06
476,Canada,CAN,Winter,1992,20879848.330000002,28371264.0,0.7359505847183968,2,3,2,7,6,6,2,14,6.705029547501507e-07,4.934570416037861e-07
477,Canada,CAN,Winter,1992,20879848.330000002,28371264.0,0.7359505847183968,2,3,2,7,6,6,2,14,6.705029547501507e-07,4.934570416037861e-07
478,China,CHN,Summer,1992,366460.6923,1164970000.0,0.0003145666345914487,16,22,16,54,48,44,16,108,0.0002947110079451214,9.270624994635055e-08
479,China,CHN,Summer,1992,366460.6923,1164970000.0,0.0003145666345914487,16,22,16,54,48,44,16,108,0.0002947110079451214,9.270624994635055e-08
480,China,CHN,Winter,1992,366460.6923,1164970000.0,0.0003145666345914487,0,3,0,3,0,6,0,6,1.637283377472897e-05,5.150347219241697e-09
481,China,CHN,Winter,1992,366460.6923,1164970000.0,0.0003145666345914487,0,3,0,3,0,6,0,6,1.637283377472897e-05,5.150347219241697e-09
482,Colombia,COL,Summer,1992,1721291.68,33939039.0,0.050717160259016174,0,0,1,1,0,0,1,1,5.809590620922539e-07,2.9464593856060567e-08
483,Cuba,CUB,Summer,1992,2048068.839,10783748.0,0.18992180075053683,14,6,11,31,42,12,11,65,3.1737214473580495e-05,6.027588923628408e-06
484,Spain,ESP,Summer,1992,16112188.92,39157685.0,0.4114693940665798,13,7,2,22,39,14,2,55,3.413564741146295e-06,1.4045774156465072e-06
485,Spain,ESP,Summer,1992,16112188.92,39157685.0,0.4114693940665798,13,7,2,22,39,14,2,55,3.413564741146295e-06,1.4045774156465072e-06
486,Spain,ESP,Winter,1992,16112188.92,39157685.0,0.4114693940665798,0,0,1,1,0,0,1,1,6.206481347538717e-08,2.553777119357286e-08
487,Spain,ESP,Winter,1992,16112188.92,39157685.0,0.4114693940665798,0,0,1,1,0,0,1,1,6.206481347538717e-08,2.553777119357286e-08
488,Estonia,EST,Summer,1992,0.0,1533091.0,0.0,1,0,1,2,3,0,1,4,0.0,2.6091080046781307e-06
489,Ethiopia,ETH,Summer,1992,201743.5026,52011554.0,0.0038788208981412092,1,0,2,3,3,0,2,5,2.4783945631763804e-05,9.613248625488098e-08
490,Finland,FIN,Summer,1992,22319059.46,5041992.0,4.4266352386120404,1,2,2,5,3,4,2,9,4.0324279865510067e-07,1.7850087822432087e-06
491,Finland,FIN,Summer,1992,22319059.46,5041992.0,4.4266352386120404,1,2,2,5,3,4,2,9,4.0324279865510067e-07,1.7850087822432087e-06
492,Finland,FIN,Winter,1992,22319059.46,5041992.0,4.4266352386120404,3,1,3,7,9,2,3,14,6.272665756857121e-07,2.77668032793388e-06
493,Finland,FIN,Winter,1992,22319059.46,5041992.0,4.4266352386120404,3,1,3,7,9,2,3,14,6.272665756857121e-07,2.77668032793388e-06
494,France,FRA,Summer,1992,23814227.37,58849943.0,0.4046601603335453,8,5,16,29,24,10,16,50,2.0995852279040366e-06,8.496184949575907e-07
495,France,FRA,Summer,1992,23814227.37,58849943.0,0.4046601603335453,8,5,16,29,24,10,16,50,2.0995852279040366e-06,8.496184949575907e-07
496,France,FRA,Winter,1992,23814227.37,58849943.0,0.4046601603335453,3,5,1,9,9,10,1,20,8.398340911616147e-07,3.3984739798303626e-07
497,France,FRA,Winter,1992,23814227.37,58849943.0,0.4046601603335453,3,5,1,9,9,10,1,20,8.398340911616147e-07,3.3984739798303626e-07
498,United Kingdom,GBR,Summer,1992,20487170.79,57580402.0,0.3558011072934155,5,3,12,20,15,6,12,33,1.6107641381165058e-06,5.731116639303769e-07
499,Ghana,GHA,Summer,1992,394907.0373,16241548.0,0.024314618120144706,0,0,1,1,0,0,1,1,2.5322415291382297e-06,6.157048576896735e-08
500,Hungary,HUN,Summer,1992,3735105.8200000003,10369341.0,0.36020667272876844,11,12,7,30,33,24,7,64,1.7134722035800312e-05,6.17204121264794e-06
501,Ireland,IRL,Summer,1992,15714384.75,3558430.0,4.416100569633237,1,1,0,2,3,2,0,5,3.181798129258608e-07,1.4051140531076907e-06
502,Israel,ISR,Summer,1992,0.0,5123000.0,0.0,0,1,1,2,0,2,1,3,0.0,5.855943782939684e-07
503,Italy,ITA,Summer,1992,23243474.53,56797087.0,0.40923708869083375,6,5,8,19,18,10,8,36,1.548821797426858e-06,6.338353232798717e-07
504,Italy,ITA,Summer,1992,23243474.53,56797087.0,0.40923708869083375,6,5,8,19,18,10,8,36,1.548821797426858e-06,6.338353232798717e-07
505,Italy,ITA,Winter,1992,23243474.53,56797087.0,0.40923708869083375,4,6,4,14,12,12,4,28,1.2046391757764452e-06,4.92983029217678e-07
506,Italy,ITA,Winter,1992,23243474.53,56797087.0,0.40923708869083375,4,6,4,14,12,12,4,28,1.2046391757764452e-06,4.92983029217678e-07
507,Jamaica,JAM,Summer,1992,1452188.3869999999,2434574.0,0.596485622125267,0,3,1,4,0,6,1,7,4.8203112369332015e-06,2.875246346999516e-06
508,Japan,JPN,Summer,1992,31414984.64,124425000.0,0.2524812910588708,3,8,11,22,9,16,11,36,1.145949947534337e-06,2.8933092224231465e-07
509,Japan,JPN,Summer,1992,31414984.64,124425000.0,0.2524812910588708,3,8,11,22,9,16,11,36,1.145949947534337e-06,2.8933092224231465e-07
510,Japan,JPN,Winter,1992,31414984.64,124425000.0,0.2524812910588708,1,2,4,7,3,4,4,11,3.5015137285771403e-07,8.84066706851517e-08
511,Japan,JPN,Winter,1992,31414984.64,124425000.0,0.2524812910588708,1,2,4,7,3,4,4,11,3.5015137285771403e-07,8.84066706851517e-08
512,Kenya,KEN,Summer,1992,332950.2514,24655723.0,0.013503974367330458,2,4,2,8,6,8,2,16,4.805522726810591e-05,6.489365572447419e-07
513,"Korea, Rep.",KOR,Summer,1992,8126670.390000001,43747962.0,0.1857611193408278,12,5,12,29,36,10,12,58,7.136994269063741e-06,1.3257760441503539e-06
514,"Korea, Rep.",KOR,Summer,1992,8126670.390000001,43747962.0,0.1857611193408278,12,5,12,29,36,10,12,58,7.136994269063741e-06,1.3257760441503539e-06
515,"Korea, Rep.",KOR,Winter,1992,8126670.390000001,43747962.0,0.1857611193408278,2,1,1,4,6,2,1,9,1.1074646279581667e-06,2.0572386891988249e-07
516,"Korea, Rep.",KOR,Winter,1992,8126670.390000001,43747962.0,0.1857611193408278,2,1,1,4,6,2,1,9,1.1074646279581667e-06,2.0572386891988249e-07
517,Lithuania,LTU,Summer,1992,0.0,3700114.0,0.0,1,0,1,2,3,0,1,4,0.0,1.081047773122666e-06
518,Luxembourg,LUX,Winter,1992,39570861.57,392175.0,100.9010303308472,0,2,0,2,0,4,0,4,1.0108448088561544e-07,1.019952827181743e-05
519,Morocco,MAR,Summer,1992,1317329.956,25400676.0,0.051862003830134284,1,1,1,3,3,2,1,6,4.554667547543419e-06,2.3621418579568513e-07
520,Mexico,MEX,Summer,1992,4272785.965,84993164.0,0.05027211323724812,0,1,0,1,0,2,0,2,4.6807867662521684e-07,2.3531304235244143e-08
521,Namibia,NAM,Summer,1992,2346287.909,1461687.0,1.605191746933509,0,2,0,2,0,4,0,4,1.7048206167097458e-06,2.736563983944579e-06
522,Norway,NOR,Summer,1992,30523985.06,4286401.0,7.1211221395291755,2,4,1,7,6,8,1,15,4.914168307485078e-07,3.4994392731804608e-06
523,Norway,NOR,Summer,1992,30523985.06,4286401.0,7.1211221395291755,2,4,1,7,6,8,1,15,4.914168307485078e-07,3.4994392731804608e-06
524,Norway,NOR,Winter,1992,30523985.06,4286401.0,7.1211221395291755,9,6,5,20,27,12,5,44,1.441489370195623e-06,1.0265021867996018e-05
525,Norway,NOR,Winter,1992,30523985.06,4286401.0,7.1211221395291755,9,6,5,20,27,12,5,44,1.441489370195623e-06,1.0265021867996018e-05
526,New Zealand,NZL,Summer,1992,11793139.24,3531700.0,3.3392245207690348,1,4,5,10,3,8,5,16,1.3567210285901788e-06,4.530396126511312e-06
527,New Zealand,NZL,Summer,1992,11793139.24,3531700.0,3.3392245207690348,1,4,5,10,3,8,5,16,1.3567210285901788e-06,4.530396126511312e-06
528,New Zealand,NZL,Winter,1992,11793139.24,3531700.0,3.3392245207690348,0,1,0,1,0,2,0,2,1.6959012857377235e-07,5.66299515813914e-07
529,New Zealand,NZL,Winter,1992,11793139.24,3531700.0,3.3392245207690348,0,1,0,1,0,2,0,2,1.6959012857377235e-07,5.66299515813914e-07
530,Pakistan,PAK,Summer,1992,399465.0488,122375179.0,0.00326426528699909,0,0,1,1,0,0,1,1,2.503347922437814e-06,8.171591724495047e-09
531,Peru,PER,Summer,1992,1560546.504,23047248.0,0.06771075245079151,0,1,0,1,0,2,0,2,1.2816023071876364e-06,8.677825656234532e-08
532,Poland,POL,Summer,1992,2459020.685,38363667.0,0.0640976443935873,3,6,10,19,9,12,10,31,1.2606644665130175e-05,8.080562267418285e-07
533,"Korea, Dem. People's Rep.",PRK,Summer,1992,0.0,21439991.0,0.0,4,0,5,9,12,0,5,17,0.0,7.929107806062045e-07
534,"Korea, Dem. People's Rep.",PRK,Summer,1992,0.0,21439991.0,0.0,4,0,5,9,12,0,5,17,0.0,7.929107806062045e-07
535,"Korea, Dem. People's Rep.",PRK,Winter,1992,0.0,21439991.0,0.0,0,0,1,1,0,0,1,1,0.0,4.664181062389439e-08
536,"Korea, Dem. People's Rep.",PRK,Winter,1992,0.0,21439991.0,0.0,0,0,1,1,0,0,1,1,0.0,4.664181062389439e-08
537,Qatar,QAT,Summer,1992,16223780.08,471293.0,34.42397845925995,0,0,1,1,0,0,1,1,6.163791638378766e-08,2.1218223058691728e-06
538,Romania,ROU,Summer,1992,1102103.785,22794284.0,0.048350006738531466,4,6,8,18,12,12,8,32,2.9035378006618498e-05,1.4038607222758126e-06
539,Suriname,SUR,Summer,1992,964433.2465,419521.0,2.2988914655047066,0,0,1,1,0,0,1,1,1.0368783984055655e-06,2.3836709008607435e-06
540,Sweden,SWE,Summer,1992,32800982.689999998,8668067.0,3.7841173458857664,1,7,4,12,3,14,4,21,6.402247212673372e-07,2.4226854730126105e-06
541,Sweden,SWE,Summer,1992,32800982.689999998,8668067.0,3.7841173458857664,1,7,4,12,3,14,4,21,6.402247212673372e-07,2.4226854730126105e-06
542,Sweden,SWE,Winter,1992,32800982.689999998,8668067.0,3.7841173458857664,1,0,3,4,3,0,3,6,1.829213489335249e-07,6.921958494321744e-07
543,Sweden,SWE,Winter,1992,32800982.689999998,8668067.0,3.7841173458857664,1,0,3,4,3,0,3,6,1.829213489335249e-07,6.921958494321744e-07
544,Thailand,THA,Summer,1992,1957407.581,56939020.0,0.0343772615159165,0,0,1,1,0,0,1,1,5.108798033208394e-07,1.7562648601960485e-08
545,Turkiye,TUR,Summer,1992,2814447.556,56302037.0,0.049988378857411496,2,2,2,6,6,4,2,12,4.263714196563271e-06,2.1313616059752865e-07
546,United States,USA,Summer,1992,25418990.78,256514000.0,0.09909397062148655,37,34,37,108,111,68,37,216,8.497583632232624e-06,8.420593028060846e-07
547,United States,USA,Summer,1992,25418990.78,256514000.0,0.09909397062148655,37,34,37,108,111,68,37,216,8.497583632232624e-06,8.420593028060846e-07
548,United States,USA,Winter,1992,25418990.78,256514000.0,0.09909397062148655,5,4,2,11,15,8,2,25,9.835166241009982e-07,9.746056745440794e-08
549,United States,USA,Winter,1992,25418990.78,256514000.0,0.09909397062148655,5,4,2,11,15,8,2,25,9.835166241009982e-07,9.746056745440794e-08
550,Australia,AUS,Winter,1994,18129790.720000003,17805468.0,1.018214782110754,0,0,1,1,0,0,1,1,5.515783471768613e-08,5.616252265876977e-08
551,Austria,AUT,Winter,1994,25646700.66,7936118.0,3.231643060246836,2,3,4,9,6,6,4,16,6.238619232981682e-07,2.0160990549787692e-06
552,Belarus,BLR,Winter,1994,1460065.5,10226955.0,0.14276639527601323,0,2,0,2,0,4,0,4,2.7396031205449343e-06,3.9112326200711746e-07
553,Canada,CAN,Winter,1994,19935381.46,29000663.0,0.6874112312535752,3,6,4,13,9,12,4,25,1.254051749657365e-06,8.620492572876696e-07
554,China,CHN,Winter,1994,473492.27869999997,1191835000.0,0.00039728005864905796,0,1,2,3,0,2,2,4,8.447867430873906e-06,3.3561692683970516e-09
555,Finland,FIN,Winter,1994,20301333.09,5088333.0,3.989780757273551,0,1,5,6,0,2,5,7,3.448049430531264e-07,1.375696126806166e-06
556,France,FRA,Winter,1994,23496367.68,59327585.0,0.3960445664525195,0,1,4,5,0,2,4,6,2.553586189029197e-07,1.0113339351332099e-07
557,United Kingdom,GBR,Winter,1994,19709238.099999998,57865745.0,0.3406028575282319,0,0,2,2,0,0,2,2,1.0147525692532987e-07,3.4562762477178856e-08
558,Italy,ITA,Winter,1994,19337630.9,56843400.0,0.3401913133274927,7,5,8,20,21,10,8,39,2.0167930705513676e-06,6.860954833806563e-07
559,Japan,JPN,Winter,1994,39933515.059999995,125178000.0,0.3190138447650545,1,2,2,5,3,4,2,9,2.2537460041966064e-07,7.189761779226381e-08
560,Kazakhstan,KAZ,Winter,1994,1316183.6290000002,16145766.0,0.08151880988489492,1,2,0,3,3,4,0,7,5.318406828474539e-06,4.335501951409428e-07
561,"Korea, Rep.",KOR,Winter,1994,10385336.17,44641540.0,0.23263839397117572,4,1,1,6,12,2,1,15,1.4443441940117766e-06,3.3600991363649195e-07
562,Norway,NOR,Winter,1994,29315841.91,4336613.0,6.760077947928487,10,11,5,26,30,22,5,57,1.9443412259825494e-06,1.3143898245012871e-05
563,Russian Federation,RUS,Winter,1994,2662104.0039999997,148407912.0,0.017937749868753627,11,8,4,23,33,16,4,53,1.990906437928937e-05,3.571238169566054e-07
564,Sweden,SWE,Winter,1994,26083614.39,8780745.0,2.97054684881522,2,1,0,3,6,2,0,8,3.0670596031610786e-07,9.110844239298602e-07
565,Ukraine,UKR,Winter,1994,1011979.37,51921400.0,0.019490602526126027,1,0,1,2,3,0,1,4,3.952649746209747e-06,7.70395251283671e-08
566,United States,USA,Winter,1994,27694853.419999998,263126000.0,0.10525319968380167,6,5,2,13,18,10,2,30,1.0832337526775039e-06,1.1401381847479915e-07
567,Uzbekistan,UZB,Winter,1994,576447.1105,22377000.0,0.02576069671984627,1,0,0,1,3,0,0,3,5.204293586271694e-06,1.340662287169862e-07
568,Argentina,ARG,Summer,1996,7690157.0030000005,35389362.0,0.21730137443562844,0,2,1,3,0,4,1,5,6.501817840714376e-07,1.4128539531173239e-07
569,Armenia,ARM,Summer,1996,484091.641,3298898.0,0.14674344008211226,1,1,0,2,3,2,0,5,1.0328622881550644e-05,1.5156576529495606e-06
570,Australia,AUS,Summer,1996,22020093.720000003,18224767.0,1.2082510421120887,9,9,23,41,27,18,23,68,3.0880885823950066e-06,3.7311862478132094e-06
571,Austria,AUT,Summer,1996,29809076.77,7959017.0,3.7453214096665453,0,1,2,3,0,2,2,4,1.3418731585896077e-07,5.02574626992253e-07
572,Azerbaijan,AZE,Summer,1996,409163.1891,7763000.0,0.05270683873502512,0,1,0,1,0,2,0,2,4.888025250754406e-06,2.576323586242432e-07
573,Burundi,BDI,Summer,1996,146536.1825,5930507.0,0.024708879443190945,1,0,0,1,3,0,0,3,2.0472759347337305e-05,5.05858942582818e-07
574,Belgium,BEL,Summer,1996,27489555.18,10156637.0,2.7065607621892953,2,2,2,6,6,4,2,12,4.3652943532278723e-07,1.1814934411853057e-06
575,Belarus,BLR,Summer,1996,1452507.105,10159569.0,0.1429693626767041,1,6,8,15,3,12,8,23,1.5834690185560228e-05,2.263875564012607e-06
576,Brazil,BRA,Summer,1996,5121905.407000001,166037122.0,0.030847953429354192,3,3,9,15,9,6,9,24,4.685756196746567e-06,1.4454598893854592e-07
577,Canada,CAN,Summer,1996,21227347.529999997,29610218.0,0.7168926459778174,3,11,8,22,9,22,8,39,1.8372526263529828e-06,1.3171128966358842e-06
578,China,CHN,Summer,1996,709413.7551,1217550000.0,0.0005826567739312553,16,22,12,50,48,44,12,104,0.00014659992036007255,8.541743665557883e-08
579,Cuba,CUB,Summer,1996,2281975.5500000003,10963031.0,0.20815188336145363,9,8,8,25,27,16,8,51,2.2349056281518876e-05,4.651998156349279e-06
580,Czechia,CZE,Summer,1996,6532837.055,10315241.0,0.6333188972511645,4,3,4,11,12,6,4,22,3.3676027451445443e-06,2.132766456934937e-06
581,Ecuador,ECU,Summer,1996,2142328.641,11775221.0,0.1819353234219553,1,0,0,1,3,0,0,3,1.4003453730608086e-06,2.5477228835025684e-07
582,Spain,ESP,Summer,1996,16109084.4,39889852.0,0.40383916190012437,5,6,6,17,15,12,6,33,2.0485335591140113e-06,8.272780756368813e-07
583,Ethiopia,ETH,Summer,1996,144031.64870000002,59347649.0,0.00242691414279949,2,0,1,3,6,0,1,7,4.860042958044678e-05,1.1794906989491698e-07
584,Finland,FIN,Summer,1996,25783450.49,5124573.0,5.0313363650005565,1,2,1,4,3,4,1,8,3.1027654747384433e-07,1.5611056765119747e-06
585,France,FRA,Summer,1996,26870285.240000002,59756533.0,0.44966272122915835,15,7,15,37,45,14,15,74,2.7539715093846916e-06,1.238358323097493e-06
586,United Kingdom,GBR,Summer,1996,24440328.14,58166950.0,0.42017551444591816,1,8,6,15,3,16,6,25,1.0228995231485463e-06,4.2979733336542485e-07
587,Georgia,GEO,Summer,1996,689059.4414,4491699.0,0.1534073056542747,0,0,2,2,0,0,2,2,2.9025072146700288e-06,4.4526581144462264e-07
588,"Hong Kong SAR, China",HKG,Summer,1996,24818154.55,6435500.0,3.856445427705695,1,0,0,1,3,0,0,3,1.2087925369132653e-07,4.66164245202393e-07
589,Hungary,HUN,Summer,1996,4525039.103,10311238.0,0.43884537462911827,7,4,10,21,21,8,10,39,8.618710051399084e-06,3.7822810413259784e-06
590,India,IND,Summer,1996,399577.5035,983281218.0,0.0004063715406999669,0,0,1,1,0,0,1,1,2.502643395188038e-06,1.0170030523251588e-09
591,Ireland,IRL,Summer,1996,20835897.71,3637510.0,5.728066097412791,3,0,1,4,9,0,1,10,4.799409240332655e-07,2.7491333357159156e-06
592,Israel,ISR,Summer,1996,20116981.87,5692000.0,3.534255423401265,0,0,1,1,0,0,1,1,4.970924597249239e-08,1.7568517217146873e-07
593,Italy,ITA,Summer,1996,23081604.68,56860281.0,0.405935466270383,13,10,12,35,39,20,12,71,3.0760426315385626e-06,1.2486747999011822e-06
594,Jamaica,JAM,Summer,1996,2919144.486,2532894.0,1.1524937427306472,1,3,2,6,3,6,2,11,3.768227318913189e-06,4.342858406234134e-06
595,Japan,JPN,Summer,1996,39150039.63,125757000.0,0.311314993439729,3,6,5,14,9,12,5,26,6.641117159962373e-07,2.0674793450861583e-07
596,Kazakhstan,KAZ,Summer,1996,1350305.67,15578227.0,0.08667903414169019,3,4,4,11,9,8,4,21,1.555203422940526e-05,1.3480353059433528e-06
597,Kenya,KEN,Summer,1996,436195.45160000003,27615736.0,0.015795177488660814,1,4,3,8,3,8,3,14,3.209570376914035e-05,5.069573376570517e-07
598,"Korea, Rep.",KOR,Summer,1996,13403049.59,45524681.0,0.2944128173023332,7,15,5,27,21,30,5,56,4.178153607801432e-06,1.2301019747947272e-06
599,Lithuania,LTU,Summer,1996,2327434.8570000003,3601613.0,0.6462201399761719,0,0,1,1,0,0,1,1,4.296575678551848e-07,2.776533736411991e-07
600,Morocco,MAR,Summer,1996,1585718.384,26999093.0,0.05873228348818977,0,0,2,2,0,0,2,2,1.2612580015342748e-06,7.407656249785872e-08
601,Moldova,MDA,Summer,1996,575145.4551,2947293.0,0.19514363013789265,0,1,1,2,0,2,1,3,5.216071818699137e-06,1.0178831897609093e-06
602,Mexico,MEX,Summer,1996,4487291.779,91586555.0,0.04899509299154226,0,0,1,1,0,0,1,1,2.2285156598906335e-07,1.0918633198944976e-08
603,Mozambique,MOZ,Summer,1996,239857.40430000002,16079553.0,0.01491691991064677,0,0,1,1,0,0,1,1,4.169143758219183e-06,6.219078353732844e-08
604,Namibia,NAM,Summer,1996,2417605.515,1650066.0,1.4651568573620692,0,2,0,2,0,4,0,4,1.6545296472820131e-06,2.424145458424087e-06
605,Norway,NOR,Summer,1996,37321974.199999996,4381336.0,8.518400369202451,2,2,3,7,6,4,3,13,3.483202665093746e-07,2.967131486834153e-06
606,New Zealand,NZL,Summer,1996,18794436.04,3732000.0,5.036022518756699,3,2,1,6,9,4,1,14,7.449013085683417e-07,3.7513397642015005e-06
607,Poland,POL,Summer,1996,4147465.5009999997,38624370.0,0.10737949903131105,7,5,5,17,21,10,5,36,8.679999867707159e-06,9.320540373862408e-07
608,"Korea, Dem. People's Rep.",PRK,Summer,1996,0.0,22614347.0,0.0,2,1,2,5,6,2,2,10,0.0,4.421971591751024e-07
609,Romania,ROU,Summer,1996,1633010.6439999999,22619004.0,0.07219639927558259,4,7,9,20,12,14,9,35,2.1432805798662022e-05,1.5473714050362252e-06
610,Russian Federation,RUS,Summer,1996,2643929.199,148160129.0,0.01784507894833164,26,21,16,63,78,42,16,136,5.143859376092166e-05,9.179257666548063e-07
611,Slovak Republic,SVK,Summer,1996,5196940.38,5373361.0,0.9671675474623797,1,1,1,3,3,2,1,6,1.1545254633073163e-06,1.1166195608298046e-06
612,Sweden,SWE,Summer,1996,32998968.159999996,8840998.0,3.7324935669027406,2,4,2,8,6,8,2,16,4.848636455061812e-07,1.8097504376768324e-06
613,Syrian Arab Republic,SYR,Summer,1996,4184294.4399999995,14708879.0,0.2844740540730534,1,0,0,1,3,0,0,3,7.169667534199626e-07,2.0395843898097197e-07
614,Thailand,THA,Summer,1996,3039890.1,60211096.0,0.050487207540616766,1,0,1,2,3,0,1,4,1.3158370429246767e-06,6.64329378757696e-08
615,Trinidad and Tobago,TTO,Summer,1996,4385098.699999999,1313434.0,3.3386517327859635,0,0,2,2,0,0,2,2,4.5609007614811505e-07,1.5227259230383864e-06
616,Tunisia,TUN,Summer,1996,2077007.469,9430550.0,0.2202424534093982,0,0,1,1,0,0,1,1,4.814619181323705e-07,1.0603835407266808e-07
617,Turkiye,TUR,Summer,1996,3009855.034,60293786.0,0.049919821488735173,4,1,1,6,12,2,1,15,4.9836287231632835e-06,2.487818562264443e-07
618,Uganda,UGA,Summer,1996,284456.8035,21249572.0,0.013386472136944686,0,0,1,1,0,0,1,1,3.515472253417205e-06,4.7059771368571566e-08
619,Ukraine,UKR,Summer,1996,872698.7305000001,51057800.0,0.017092368462800985,9,2,12,23,27,4,12,43,4.9272444770675644e-05,8.421827810833996e-07
620,United States,USA,Summer,1996,29967712.72,269394000.0,0.11124120329331759,44,32,25,101,132,64,25,221,7.3746035296350105e-06,8.203597704477457e-07
621,Uzbekistan,UZB,Summer,1996,600598.1577999999,23225000.0,0.025859985265877284,0,1,1,2,0,2,1,3,4.995020316061317e-06,1.2917115177610334e-07
622,Australia,AUS,Winter,1998,21478385.16,18607584.0,1.154281241455097,0,0,1,1,0,0,1,1,4.655843502901407e-08,5.374152818549684e-08
623,Austria,AUT,Winter,1998,27361875.11,7976789.0,3.4301866465315807,3,5,9,17,9,10,9,28,1.023321679798428e-06,3.510184361150834e-06
624,Belgium,BEL,Winter,1998,25338443.29,10203008.0,2.4834287388581875,0,0,1,1,0,0,1,1,3.946572362614941e-08,9.801031225301402e-08
625,Belarus,BLR,Winter,1998,1511325.3159999999,10071963.0,0.15005270730243944,0,0,2,2,0,0,2,2,1.3233418237797852e-06,1.985710233447045e-07
626,Canada,CAN,Winter,1998,21024585.07,30155173.0,0.6972132134675533,6,5,4,15,18,10,4,32,1.5220276592122062e-06,1.0611777952658404e-06
627,China,CHN,Winter,1998,828580.4793,1241935000.0,0.0006671689575541393,0,6,2,8,0,12,2,14,1.6896367160167055e-05,1.1272731664700648e-08
628,Czechia,CZE,Winter,1998,6489703.619,10294373.0,0.6304127137223413,1,1,1,3,3,2,1,6,9.24541450927545e-07,5.828426850280245e-07
629,Finland,FIN,Winter,1998,26009269.49,5153498.0,5.046915607612537,2,4,6,12,6,8,6,20,7.689566217032573e-07,3.880859175651179e-06
630,France,FRA,Winter,1998,24971574.49,60192790.0,0.41485989418333985,2,1,5,8,6,2,5,13,5.205919236372508e-07,2.1597271035285122e-07
631,United Kingdom,GBR,Winter,1998,28297866.0,58487141.0,0.4838305568740315,0,0,1,1,0,0,1,1,3.5338353782578516e-08,1.7097775389636502e-08
632,Italy,ITA,Winter,1998,22318137.299999997,56906744.0,0.39218791537256104,2,6,2,10,6,12,2,20,8.961321337511443e-07,3.5145219343422636e-07
633,Japan,JPN,Winter,1998,32423755.61,126400000.0,0.25651705387658225,5,1,4,10,15,2,4,21,6.476732755018444e-07,1.661392405063291e-07
634,Kazakhstan,KAZ,Winter,1998,1468669.291,15071640.0,0.09744588452218869,0,0,2,2,0,0,2,2,1.36177695840445e-06,1.3269956023365738e-07
635,"Korea, Rep.",KOR,Winter,1998,8281699.982,46286503.0,0.17892256803241324,3,1,2,6,9,2,2,13,1.5697260258467547e-06,2.8085941165181565e-07
636,Norway,NOR,Winter,1998,34788359.85,4431464.0,7.8503085774813925,10,10,5,25,30,20,5,55,1.5809885903545982e-06,1.2411248291760917e-05
637,Russian Federation,RUS,Winter,1998,1834861.816,147670784.0,0.012425354334138296,9,6,3,18,27,12,3,42,2.2890007102311404e-05,2.8441644895716135e-07
638,Sweden,SWE,Winter,1998,30596527.2,8850974.0,3.4568542625930205,0,2,1,3,0,4,1,5,1.634172390649616e-07,5.649095794428952e-07
639,Ukraine,UKR,Winter,1998,835250.9765999999,50144500.0,0.016656881145489535,0,1,0,1,0,2,0,2,2.3944898671549785e-06,3.98847331212795e-08
640,United States,USA,Winter,1998,32853676.95,275854000.0,0.11909806256207994,6,3,4,13,18,6,4,28,8.522638133507306e-07,1.0150296896184213e-07
641,Argentina,ARG,Summer,2000,7666517.834,37070774.0,0.20680760088796635,0,2,2,4,0,4,2,6,7.826238886956981e-07,1.6185256881876813e-07
642,Armenia,ARM,Summer,2000,603298.0252,3168523.0,0.19040354928779119,0,0,1,1,0,0,1,1,1.6575555666181549e-06,3.1560446302583253e-07
643,Australia,AUS,Summer,2000,21853781.67,19028802.0,1.1484580936834594,16,25,17,58,48,50,17,115,5.262247135829466e-06,6.043470314105954e-06
644,Austria,AUT,Summer,2000,24625600.72,8011566.0,3.073756206963782,2,1,0,3,6,2,0,8,3.248651714515414e-07,9.985563371755285e-07
645,Azerbaijan,AZE,Summer,2000,655119.9452,8048600.0,0.08139551539398156,2,0,1,3,6,0,1,7,1.068506622533525e-05,8.697164724299879e-07
646,Belgium,BEL,Summer,2000,23098886.51,10251250.0,2.253275113766614,0,2,3,5,0,4,3,7,3.030449107133173e-07,6.828435556639435e-07
647,Belarus,BLR,Summer,2000,1276288.034,9979610.0,0.12788957023370653,3,3,11,17,9,6,11,26,2.037157703227358e-05,2.6053122316403144e-06
648,Brazil,BRA,Summer,2000,3726811.42,175873720.0,0.02119026890430247,0,6,6,12,0,12,6,18,4.829866062823216e-06,1.0234616064298862e-07
649,Canada,CAN,Summer,2000,24271002.06,30685730.0,0.7909540382451387,3,3,8,14,9,6,8,23,9.476328971973233e-07,7.495340668121631e-07
650,Channel Islands,CHI,Summer,2000,44316153.59,145306.0,304.9850218848499,0,0,1,1,0,0,1,1,2.2565135260873618e-08,6.882028271372139e-06
651,China,CHN,Summer,2000,959372.4836,1262645000.0,0.000759811731405106,28,16,14,58,84,32,14,130,0.00013550524141799558,1.0295847209627409e-07
652,Cameroon,CMR,Summer,2000,700163.2135999999,15091594.0,0.04639425189943487,1,0,0,1,3,0,0,3,4.2847152517125624e-06,1.987861587053031e-07
653,Colombia,COL,Summer,2000,2547143.528,39215135.0,0.06495307304182428,1,0,0,1,3,0,0,3,1.1777899309645813e-06,7.650107541386763e-08
654,Cuba,CUB,Summer,2000,2752203.783,11105791.0,0.2478169977266815,11,11,7,29,33,22,7,62,2.2527401634633974e-05,5.582673039678128e-06
655,Czechia,CZE,Summer,2000,6029038.193,10255063.0,0.5879084500017211,2,3,3,8,6,6,3,15,2.4879590275967587e-06,1.4626921355821998e-06
656,Spain,ESP,Summer,2000,14749687.42,40567864.0,0.36358057747383493,3,3,5,11,9,6,5,20,1.355960938730185e-06,4.93001061135484e-07
657,Estonia,EST,Summer,2000,4070609.0239999997,1396985.0,2.9138530649935395,1,0,2,3,3,0,2,5,1.228317426340968e-06,3.579136497528606e-06
658,Ethiopia,ETH,Summer,2000,122962.2935,67031867.0,0.0018343856288532139,4,1,3,8,12,2,3,17,0.00013825376476082077,2.536107192121025e-07
659,Finland,FIN,Summer,2000,24345914.82,5176209.0,4.703425773572898,2,1,1,4,6,2,1,9,3.696718758173984e-07,1.7387242284845918e-06
660,France,FRA,Summer,2000,22416425.419999998,60921384.0,0.36795660157687815,13,14,11,38,39,28,11,78,3.479591350475004e-06,1.2803386081970822e-06
661,United Kingdom,GBR,Summer,2000,28290972.5,58892514.0,0.4803831689032667,11,10,7,28,33,20,7,60,2.1208178686681765e-06,1.0188052084174908e-06
662,Georgia,GEO,Summer,2000,749908.535,4077131.0,0.18393044888672944,0,0,6,6,0,0,6,6,8.000975745662102e-06,1.4716230604314653e-06
663,Hungary,HUN,Summer,2000,4624281.657000001,10210971.0,0.4528738409892654,8,6,3,17,24,12,3,39,8.433742339410446e-06,3.8194212871626016e-06
664,India,IND,Summer,2000,442034.7789,1059633675.0,0.00041715810787157175,0,0,1,1,0,0,1,1,2.2622654318931467e-06,9.43722367071809e-10
665,Ireland,IRL,Summer,2000,26334567.21,3805174.0,6.9207261507620945,0,1,0,1,0,2,0,2,7.594580856603338e-08,5.256001433837191e-07
666,Iceland,ISL,Summer,2000,32096372.26,281205.0,114.13869689372522,0,0,1,1,0,0,1,1,3.1156169049243196e-08,3.5561245354812328e-06
667,Israel,ISR,Summer,2000,21630747.61,6289000.0,3.4394574034027667,0,0,1,1,0,0,1,1,4.623048717639769e-08,1.590077913817777e-07
668,Italy,ITA,Summer,2000,20137591.22,56942108.0,0.35365025861002547,13,8,13,34,39,16,13,68,3.376769309552009e-06,1.1941953395894651e-06
669,Jamaica,JAM,Summer,2000,3447303.8959999997,2612205.0,1.3196911789082402,0,6,3,9,0,12,3,15,4.351226480904369e-06,5.7422752042814406e-06
670,Japan,JPN,Summer,2000,39169359.57,126843000.0,0.3088019013268371,5,8,5,18,15,16,5,36,9.190857444494081e-07,2.838154253683688e-07
671,Kazakhstan,KAZ,Summer,2000,1229001.247,14883626.0,0.08257404795041208,3,4,0,7,9,8,0,17,1.3832370017115207e-05,1.1421947850611135e-06
672,Kenya,KEN,Summer,2000,411821.5792,30851606.0,0.013348464880564077,2,3,2,7,6,6,2,14,3.399530453745587e-05,4.5378512872231026e-07
673,Kyrgyz Republic,KGZ,Summer,2000,279619.56930000003,4898400.0,0.057083857851543365,0,0,1,1,0,0,1,1,3.5762876057044263e-06,2.0414829332026783e-07
674,"Korea, Rep.",KOR,Summer,2000,12256993.57,47008111.0,0.26074209980486135,8,10,10,28,24,20,10,54,4.405648064642005e-06,1.1487379273759799e-06
675,Lithuania,LTU,Summer,2000,3293229.9790000003,3499536.0,0.9410476071684932,2,0,3,5,6,0,3,9,2.7328792879302277e-06,2.5717695145870767e-06
676,Morocco,MAR,Summer,2000,1348049.8050000002,28554415.0,0.04720985546368224,0,1,4,5,0,2,4,6,4.450874127755242e-06,2.1012512425836774e-07
677,Moldova,MDA,Summer,2000,440538.684,2924668.0,0.1506286128887108,0,1,1,2,0,2,1,3,6.8098446491931685e-06,1.0257574534955762e-06
678,Mexico,MEX,Summer,2000,7232878.808999999,97873442.0,0.07390032128429691,1,2,3,6,3,4,3,10,1.3825753567938707e-06,1.0217276306681847e-07
679,North Macedonia,MKD,Summer,2000,1861898.0650000002,2026350.0,0.9188432723863105,0,0,1,1,0,0,1,1,5.370863307707449e-07,4.934981617193476e-07
680,Mozambique,MOZ,Summer,2000,318342.6885,17768505.0,0.01791612116494888,1,0,0,1,3,0,0,3,9.423806823193302e-06,1.688380648794032e-07
681,Norway,NOR,Summer,2000,38131460.61,4490967.0,8.490701581641549,4,3,3,10,12,6,3,21,5.507263468027956e-07,4.676053063850168e-06
682,New Zealand,NZL,Summer,2000,13641102.72,3857700.0,3.5360714207947743,1,0,3,4,3,0,3,6,4.3984713869231826e-07,1.5553308966482619e-06
683,Poland,POL,Summer,2000,4501454.067,38258629.0,0.11765853049778652,6,5,3,14,18,10,3,31,6.886663628817164e-06,8.102747225991815e-07
684,"Korea, Dem. People's Rep.",PRK,Summer,2000,0.0,23367059.0,0.0,0,1,3,4,0,2,3,5,0.0,2.1397643580221199e-07
685,Qatar,QAT,Summer,2000,27494771.33,645937.0,42.565716672059345,0,0,1,1,0,0,1,1,3.637055162226003e-08,1.548138595559629e-06
686,Romania,ROU,Summer,2000,1659907.64,22442971.0,0.07396113642886229,11,6,9,26,33,12,9,54,3.2531930511507254e-05,2.406098550855856e-06
687,Russian Federation,RUS,Summer,2000,1771594.116,146596869.0,0.01208480186572061,32,28,29,89,96,56,29,181,0.00010216787150358768,1.23467848416326e-06
688,Slovak Republic,SVK,Summer,2000,5426624.281,5388720.0,1.0070340045502457,1,3,1,5,3,6,1,10,1.8427662359107038e-06,1.8557282619991389e-06
689,Sweden,SWE,Summer,2000,29624912.67,8872109.0,3.3391060310462826,4,5,3,12,12,10,3,25,8.43884344182946e-07,2.817819303166812e-06
690,Thailand,THA,Summer,2000,2004107.209,63066603.0,0.03177763053132892,1,0,2,3,3,0,2,5,2.494876510371357e-06,7.928126396787218e-08
691,Trinidad and Tobago,TTO,Summer,2000,6120942.704,1332203.0,4.594602101931913,0,1,1,2,0,2,1,3,4.901205819227025e-07,2.2519090559021412e-06
692,Turkiye,TUR,Summer,2000,4278393.130000001,64113547.0,0.06673149950664874,3,0,2,5,9,0,2,11,2.5710587283034454e-06,1.715706042593463e-07
693,Ukraine,UKR,Summer,2000,658348.6328,49176500.0,0.013387464191229551,3,10,10,23,9,20,10,39,5.923912962973802e-05,7.930617266377233e-07
694,United States,USA,Summer,2000,36329956.07,282162411.0,0.1287554778868118,37,24,32,93,111,48,32,191,5.2573694180082176e-06,6.769151118431576e-07
695,Uzbekistan,UZB,Summer,2000,558226.8024,24650400.0,0.022645750267744135,1,1,2,4,3,2,2,7,1.2539706029708184e-05,2.839710511796969e-07
696,Australia,AUS,Winter,2002,20291178.55,19495210.0,1.0408289292600592,2,0,0,2,6,0,0,6,2.9569499796255055e-07,3.077679081169169e-07
697,Austria,AUT,Winter,2002,26527593.09,8081957.0,3.282322968310769,3,3,10,16,9,6,10,25,9.42414938105491e-07,3.093310197022825e-06
698,Belarus,BLR,Winter,2002,1479314.583,9865548.0,0.14994753286892934,0,0,1,1,0,0,1,1,6.759887393065738e-07,1.0136284370619858e-07
699,Canada,CAN,Winter,2002,24255338.58,31360079.0,0.7734463481421714,7,3,7,17,21,6,7,34,1.4017532630129956e-06,1.0841809422737742e-06
700,China,CHN,Winter,2002,1148508.29,1280400000.0,0.0008969917916276164,2,2,4,8,6,4,4,14,1.2189724812521815e-05,1.0934083099031552e-08
701,Czechia,CZE,Winter,2002,8060868.703,10196916.0,0.7905202615182865,1,2,0,3,3,4,0,7,8.68392757395344e-07,6.864820696767533e-07
702,Estonia,EST,Winter,2002,5341628.947,1379350.0,3.8725696501975566,1,1,1,3,3,2,1,6,1.1232528615395046e-06,4.349874941095444e-06
703,Finland,FIN,Winter,2002,26997752.990000002,5200598.0,5.191278577963534,4,2,1,7,12,4,1,17,6.296820334009582e-07,3.268854850922913e-06
704,France,FRA,Winter,2002,24288270.02,61816234.0,0.3929108657767796,4,5,2,11,12,10,2,24,9.881313070151713e-07,3.8824752734047175e-07
705,United Kingdom,GBR,Winter,2002,30079660.04,59370479.0,0.5066433781004193,1,0,0,1,3,0,0,3,9.97351697462868e-08,5.053016331567748e-08
706,Italy,ITA,Winter,2002,22376297.900000002,57059007.0,0.39216066098030766,4,4,5,13,12,8,5,25,1.1172536275538233e-06,4.3814292106415384e-07
707,Japan,JPN,Winter,2002,32820793.640000004,127445000.0,0.257529080309153,0,1,1,2,0,2,1,3,9.140546791482157e-08,2.3539566087331792e-08
708,"Korea, Rep.",KOR,Winter,2002,13165065.74,47644736.0,0.2763173195040896,2,2,0,4,6,4,0,10,7.59586028470527e-07,2.098867753197331e-07
709,Norway,NOR,Winter,2002,43084472.47,4538159.0,9.493821717132432,13,5,7,25,39,10,7,56,1.2997722100228375e-06,1.233980563484003e-05
710,Poland,POL,Winter,2002,5207171.421,38230364.0,0.13620512273961086,0,1,1,2,0,2,1,3,5.76128526881466e-07,7.847165671768126e-08
711,Russian Federation,RUS,Winter,2002,2377529.5409999997,145306497.0,0.01636216955254244,5,4,4,13,15,8,4,27,1.1356325771937066e-05,1.858141277743417e-07
712,Sweden,SWE,Winter,2002,29899195.25,8924958.0,3.3500656529700197,0,2,5,7,0,4,5,9,3.0101144611910583e-07,1.0084081067944522e-06
713,United States,USA,Winter,2002,37997759.660000004,287625193.0,0.1321085933525997,8,12,11,31,24,24,11,59,1.5527231217820696e-06,2.0512806748468656e-07
714,Argentina,ARG,Summer,2004,4258160.261,38668796.0,0.11011877020944744,2,0,4,6,6,0,4,10,2.3484320427271962e-06,2.586064484655793e-07
715,Australia,AUS,Summer,2004,30819993.490000002,19932722.0,1.546200939841533,17,16,17,50,51,32,17,100,3.2446470189049996e-06,5.016876270084939e-06
716,Austria,AUT,Summer,2004,36889233.51,8171966.0,4.514119798099991,2,4,1,7,6,8,1,15,4.0662270729842553e-07,1.8355436133728408e-06
717,Azerbaijan,AZE,Summer,2004,1045009.3790000001,8306500.0,0.12580622151327275,1,0,4,5,3,0,4,7,6.69850447342253e-06,8.427135375910432e-07
718,Belgium,BEL,Summer,2004,35429407.79,10421137.0,3.399764132263111,1,0,2,3,3,0,2,5,1.4112570070706225e-07,4.79794095404369e-07
719,Belarus,BLR,Summer,2004,2378623.286,9730146.0,0.24445915672796686,2,5,6,13,6,10,6,22,9.249047602235573e-06,2.2610143773793323e-06
720,Brazil,BRA,Summer,2004,3623247.9960000003,184722043.0,0.019614594648024765,5,2,3,10,15,4,3,22,6.071900136089939e-06,1.1909785991269055e-07
721,Canada,CAN,Summer,2004,32143681.41,31940655.0,1.0063563633870376,3,6,3,12,9,12,3,24,7.466475197372236e-07,7.513934826947037e-07
722,Channel Islands,CHI,Summer,2004,57202561.029999994,149538.0,382.52859493907897,2,0,1,3,6,0,1,7,1.2237214337883993e-07,4.681084406639115e-05
723,China,CHN,Summer,2004,1508668.098,1296075000.0,0.0011640283918754701,32,17,14,63,96,34,14,144,9.544842910836178e-05,1.1110468144204618e-07
724,Cameroon,CMR,Summer,2004,1119980.93,16809407.0,0.06662822370830809,1,0,0,1,3,0,0,3,2.678617036809725e-06,1.7847149515744368e-07
725,Colombia,COL,Summer,2004,2811197.871,41648268.0,0.06749855410553927,0,0,2,2,0,0,2,2,7.11440493261529e-07,4.802120462728486e-08
726,Cuba,CUB,Summer,2004,3403296.163,11225294.0,0.30318102697354743,9,7,11,27,27,14,11,52,1.527930497655017e-05,4.632395374232514e-06
727,Czechia,CZE,Summer,2004,11749852.66,10197101.0,1.1522738335140545,1,3,5,9,3,6,5,14,1.19150430265906e-06,1.3729392304734453e-06
728,Dominican Republic,DOM,Summer,2004,2468437.673,9043127.0,0.27296284493184714,1,0,0,1,3,0,0,3,1.2153436292170865e-06,3.3174365460089195e-07
729,"Egypt, Arab Rep.",EGY,Summer,2004,1016253.884,77522427.0,0.013109159804813643,1,1,3,5,3,2,3,8,7.87204863465004e-06,1.0319594354289244e-07
730,Eritrea,ERI,Summer,2004,401374.5252,2763140.0,0.14526029271046706,0,0,1,1,0,0,1,1,2.491438637022896e-06,3.61907105684113e-07
731,Spain,ESP,Summer,2004,24907000.85,42921895.0,0.5802866078023815,3,11,6,20,9,22,6,37,1.4855261066086966e-06,8.620309052058395e-07
732,Estonia,EST,Summer,2004,8914103.557,1362550.0,6.542221244724964,0,1,2,3,0,2,2,4,4.487271181473891e-07,2.935672085428058e-06
733,Ethiopia,ETH,Summer,2004,134542.48630000002,75301026.0,0.0017867284610438112,2,3,2,7,6,6,2,14,0.00010405634967071363,1.8592044150899086e-07
734,Finland,FIN,Summer,2004,37772178.11,5228172.0,7.224738992902299,0,2,0,2,0,4,0,4,1.0589804983846085e-07,7.650857699402391e-07
735,France,FRA,Summer,2004,33797162.44,62716306.0,0.5388895583231575,11,9,13,33,33,18,13,64,1.8936500989874227e-06,1.0204682654619358e-06
736,United Kingdom,GBR,Summer,2004,40390785.83,59987905.0,0.6733154930148002,9,9,12,30,27,18,12,57,1.411212949406486e-06,9.501915427784984e-07
737,Georgia,GEO,Summer,2004,1305047.486,3927340.0,0.3322980658664643,2,2,0,4,6,4,0,10,7.662556425935293e-06,2.5462526799309456e-06
738,"Hong Kong SAR, China",HKG,Summer,2004,24928100.37,6783500.0,3.6748139411808065,0,1,0,1,0,2,0,2,8.023074242780739e-08,2.9483305078499297e-07
739,Hungary,HUN,Summer,2004,10301703.39,10107146.0,1.0192494884312546,8,6,3,17,24,12,3,39,3.7857816832367563e-06,3.858656043951477e-06
740,India,IND,Summer,2004,624105.0944,1136264583.0,0.000549260360427867,0,1,0,1,0,2,0,2,3.204588486691898e-06,1.7601534272233846e-09
741,Israel,ISR,Summer,2004,20557078.63,6809000.0,3.0191039256865912,1,0,1,2,3,0,1,4,1.9458017707645456e-07,5.874577764723161e-07
742,Italy,ITA,Summer,2004,31317200.79,57685327.0,0.5428971701937305,10,11,11,32,30,22,11,63,2.0116740452779144e-06,1.0921321465335543e-06
743,Jamaica,JAM,Summer,2004,3819284.231,2664024.0,1.4336523360900653,2,1,2,5,6,2,2,10,2.6182916471188394e-06,3.753719936457029e-06
744,Japan,JPN,Summer,2004,38298980.17,127761000.0,0.2997705103278778,16,9,12,37,48,18,12,78,2.0366077544043385e-06,6.10514945875502e-07
745,Kazakhstan,KAZ,Summer,2004,2874288.483,15012984.0,0.1914535100417079,1,4,3,8,3,8,3,14,4.870770656043435e-06,9.32526138707668e-07
746,Kenya,KEN,Summer,2004,462618.21579999995,34791836.0,0.013296746276913927,1,4,2,7,3,8,2,13,2.8100925462952775e-05,3.736508760273531e-07
747,"Korea, Rep.",KOR,Summer,2004,16496120.09,48082519.0,0.34307936508068554,9,12,9,30,27,24,9,60,3.63721891406284e-06,1.2478547556961398e-06
748,Lithuania,LTU,Summer,2004,6700327.192,3377075.0,1.9840623000673658,1,2,0,3,3,4,0,7,1.044725100642518e-06,2.0727996861189046e-06
749,Morocco,MAR,Summer,2004,1964080.078,30033125.0,0.06539712660603916,2,1,0,3,6,2,0,8,4.0731536812624805e-06,2.663725469793769e-07
750,Mexico,MEX,Summer,2004,7525465.234,103945813.0,0.07239796406229465,0,3,1,4,0,6,1,7,9.301750499589113e-07,6.734277983856839e-08
751,Norway,NOR,Summer,2004,57603836.02,4591910.0,12.544635243286564,5,0,1,6,15,0,1,16,2.777592796848601e-07,3.4843888490845857e-06
752,New Zealand,NZL,Summer,2004,25420234.88,4087500.0,6.21901770764526,3,2,0,5,9,4,0,13,5.114036145365467e-07,3.180428134556575e-06
753,Poland,POL,Summer,2004,6681386.472,38182222.0,0.17498684262010733,3,2,5,10,9,4,5,18,2.6940516127054535e-06,4.7142358556293556e-07
754,"Korea, Dem. People's Rep.",PRK,Summer,2004,0.0,23948930.0,0.0,0,4,1,5,0,8,1,9,0.0,3.7579967038193355e-07
755,Romania,ROU,Summer,2004,3494944.517,21451748.0,0.16292119956844542,8,5,6,19,24,10,6,40,1.1445103006766846e-05,1.864649911046876e-06
756,Russian Federation,RUS,Summer,2004,4102364.7460000003,144067316.0,0.028475332642415578,28,26,36,90,84,52,36,172,4.192703736733993e-05,1.1938863357459925e-06
757,Slovak Republic,SVK,Summer,2004,10691446.55,5372280.0,1.9901134248401053,2,2,2,6,6,4,2,12,1.1223925540739853e-06,2.233688489803212e-06
758,Sweden,SWE,Summer,2004,42821673.14,8993531.0,4.761386060714084,4,2,1,7,12,4,1,17,3.9699523053246114e-07,1.890247556827235e-06
759,Syrian Arab Republic,SYR,Summer,2004,6241058.232000001,18084007.0,0.3451147874472732,0,0,1,1,0,0,1,1,1.602292372265755e-07,5.529747914828832e-08
760,Thailand,THA,Summer,2004,2647261.7199999997,65311166.0,0.040533064744242966,3,1,4,8,9,2,4,15,5.66623235121611e-06,2.296697627477666e-07
761,Trinidad and Tobago,TTO,Summer,2004,9756500.371,1361172.0,7.167720443118136,0,0,1,1,0,0,1,1,1.0249576815190592e-07,7.346610127155128e-07
762,Turkiye,TUR,Summer,2004,6031947.927,67785075.0,0.08898637239834875,3,3,4,10,9,6,4,19,3.149894566389217e-06,2.802976909002461e-07
763,Ukraine,UKR,Summer,2004,1416603.76,47451626.0,0.02985363999960718,8,5,9,22,24,10,9,43,3.035428904974811e-05,9.061860177351983e-07
764,United States,USA,Summer,2004,41724631.63,292805298.0,0.14249957878152875,36,39,26,101,108,78,26,212,5.080931615644799e-06,7.240306150471362e-07
765,Uzbekistan,UZB,Summer,2004,465119.8869,25864350.0,0.017983049521832172,2,1,2,5,6,2,2,10,2.1499833229341113e-05,3.866325656743742e-07
766,"Venezuela, RB",VEN,Summer,2004,4287707.147,26226927.0,0.16348492322413524,0,0,2,2,0,0,2,2,4.664497670740758e-07,7.625750435802105e-08
767,Australia,AUS,Winter,2006,36570720.370000005,20450966.0,1.7882148144004544,1,0,1,2,3,0,1,4,1.0937711807507387e-07,1.9558978289827484e-07
768,Austria,AUT,Winter,2006,40669326.96,8268641.0,4.918501959390908,9,7,7,23,27,14,7,48,1.1802506603369666e-06,5.805065185439784e-06
769,Belarus,BLR,Winter,2006,3847434.124,9604924.0,0.40056892943660977,0,1,0,1,0,2,0,2,5.198269640340696e-07,2.082265304754103e-07
770,Canada,CAN,Winter,2006,40504060.73,32571174.0,1.243555443534212,6,9,6,21,18,18,6,42,1.0369330690068813e-06,1.2894837625441442e-06
771,China,CHN,Winter,2006,2099229.435,1311020000.0,0.00160121846730027,2,4,5,11,6,8,5,19,9.050940160811912e-06,1.449253253192171e-08
772,Czechia,CZE,Winter,2006,15261797.59,10238905.0,1.490569312831792,1,2,1,4,3,4,1,8,5.241846481597847e-07,7.81333550804505e-07
773,Estonia,EST,Winter,2006,12639400.07,1346810.0,9.38469425531441,3,0,0,3,9,0,0,9,7.120591127866719e-07,6.682457065213356e-06
774,Finland,FIN,Winter,2006,41222602.0,5266268.0,7.827668853920841,0,6,3,9,0,12,3,15,3.638780492313416e-07,2.848316872593647e-06
775,France,FRA,Winter,2006,36470212.84,63628261.0,0.5731763255324549,3,2,4,9,9,4,4,17,4.6613383021868864e-07,2.6717687601111713e-07
776,Italy,ITA,Winter,2006,33529726.6,58143979.0,0.5766672177698744,5,0,6,11,15,0,6,21,6.26309908533522e-07,3.611723924157306e-07
777,Japan,JPN,Winter,2006,35991546.0,127854000.0,0.2815050448167441,1,0,0,1,3,0,0,3,8.33529073744151e-08,2.346426392604064e-08
778,"Korea, Rep.",KOR,Winter,2006,21743477.45,48438292.0,0.44889025917759445,6,3,2,11,18,6,2,26,1.1957608924233967e-06,5.367654169143702e-07
779,Norway,NOR,Winter,2006,74148320.08,4660677.0,15.909345376218948,2,8,9,19,6,16,9,31,4.180809486520197e-07,6.651394207322241e-06
780,Poland,POL,Winter,2006,9035410.467,38141267.0,0.23689329636060596,0,1,1,2,0,2,1,3,3.320269744199104e-07,7.865496445097118e-08
781,Russian Federation,RUS,Winter,2006,6920188.965,143049637.0,0.04837613789261136,8,6,8,22,24,12,8,44,6.35820787879309e-06,3.075855410943825e-07
782,Slovak Republic,SVK,Winter,2006,13170784.98,5373054.0,2.4512660732611287,0,1,0,1,0,2,0,2,1.5185123764734028e-07,3.7222778702763827e-07
783,Sweden,SWE,Winter,2006,46593602.160000004,9080505.0,5.131168603508286,7,2,5,14,21,4,5,30,6.438652220315906e-07,3.3037810121793886e-06
784,Ukraine,UKR,Winter,2006,2391323.9749999996,46787786.0,0.05111000497010052,0,0,2,2,0,0,2,2,8.36356771775351e-07,4.2746198762215424e-08
785,United States,USA,Winter,2006,46302000.88,298379912.0,0.15517800970462114,9,9,7,25,27,18,7,52,1.1230616174615735e-06,1.7427446657333957e-07
786,Afghanistan,AFG,Summer,2008,387849.1743,26427199.0,0.014676136290493745,0,0,1,1,0,0,1,1,2.5783218484474676e-06,3.783980284857279e-08
787,Argentina,ARG,Summer,2008,8977506.851,40273769.0,0.22291201131436195,2,0,4,6,6,0,4,10,1.1138950006912114e-06,2.4830057499709054e-07
788,Armenia,ARM,Summer,2008,3908949.06,2983421.0,1.3102237532014422,0,1,4,5,0,2,4,6,1.5349394192412423e-06,2.0111140868151025e-06
789,Australia,AUS,Summer,2008,49679180.53,21249199.0,2.3379319159277485,14,15,17,46,42,30,17,89,1.7914949290730581e-06,4.188393171902621e-06
790,Austria,AUT,Summer,2008,51919983.58,8321496.0,6.23926077474531,0,1,2,3,0,2,2,4,7.704162683019092e-08,4.806828003041761e-07
791,Azerbaijan,AZE,Summer,2008,5574603.801999999,8763400.0,0.6361233998219868,1,1,4,6,3,2,4,9,1.6144645107821066e-06,1.0269986534906544e-06
792,Belgium,BEL,Summer,2008,48303397.96,10709973.0,4.510132561491985,2,0,0,2,6,0,0,6,1.242148638273563e-07,5.602255019690526e-07
793,Belarus,BLR,Summer,2008,6377369.732,9527985.0,0.6693303706922292,3,4,7,14,9,8,7,24,3.7633069758483937e-06,2.5188956531732576e-06
794,Brazil,BRA,Summer,2008,8801599.484000001,192672317.0,0.045681702597680396,3,4,10,17,9,8,10,27,3.067624248192841e-06,1.4013429858737828e-07
795,Canada,CAN,Summer,2008,46710505.58,33247118.0,1.4049490118211148,3,9,8,20,9,18,8,35,7.492961072762596e-07,1.052722825479189e-06
796,Channel Islands,CHI,Summer,2008,0.0,154475.0,0.0,0,1,0,1,0,2,0,2,0.0,1.2947078815342289e-05
797,China,CHN,Summer,2008,3468304.602,1324655000.0,0.002618270117124836,48,22,30,100,144,44,30,218,6.285491760853132e-05,1.6457115248876122e-07
798,Cameroon,CMR,Summer,2008,1476009.215,18777081.0,0.07860695786528268,1,0,0,1,3,0,0,3,2.032507635800905e-06,1.5976924208826706e-07
799,Colombia,COL,Summer,2008,5527449.953000001,43815313.0,0.12615338279108038,0,2,1,3,0,4,1,5,9.045762589467266e-07,1.1411535505862985e-07
800,Cuba,CUB,Summer,2008,4992824.494000001,11276609.0,0.44275938750736155,3,10,17,30,9,20,17,46,9.213221905812896e-06,4.0792404879871244e-06
801,Czechia,CZE,Summer,2008,22804577.68,10384603.0,2.195998988117312,3,3,1,7,9,6,1,16,7.016135192028692e-07,1.5407425782189267e-06
802,Dominican Republic,DOM,Summer,2008,5053324.5770000005,9522948.0,0.530647082920121,1,1,0,2,3,2,0,5,9.894476247888953e-07,5.250474957964697e-07
803,Ecuador,ECU,Summer,2008,4260433.184,14496797.0,0.29388789702994395,0,1,0,1,0,2,0,2,4.6943583284229715e-07,1.37961509704523e-07
804,"Egypt, Arab Rep.",EGY,Summer,2008,1941899.973,83844783.0,0.023160653573401222,0,0,2,2,0,0,2,2,1.0299191656665212e-06,2.3853601004608718e-08
805,Spain,ESP,Summer,2008,35510722.23,45954106.0,0.7727431849071331,5,11,3,19,15,22,3,40,1.1264203454078833e-06,8.704336452546808e-07
806,Estonia,EST,Summer,2008,18204966.48,1337090.0,13.615363573132699,1,1,0,2,3,2,0,5,2.7465032717819097e-07,3.739464060010919e-06
807,Ethiopia,ETH,Summer,2008,320861.08969999995,84357105.0,0.0038036048024644746,4,2,1,7,12,4,1,17,5.298242929952875e-05,2.0152422252992206e-07
808,Finland,FIN,Summer,2008,53772794.24,5313399.0,10.120225159074257,1,1,2,4,3,2,2,7,1.3017735267312752e-07,1.3174241196642676e-06
809,France,FRA,Summer,2008,45515961.75,64379696.0,0.7069924926330811,7,16,20,43,21,32,20,73,1.603832967453445e-06,1.1338978674270224e-06
810,United Kingdom,GBR,Summer,2008,47429936.34,61806995.0,0.7673878391919879,19,13,19,51,57,26,19,102,2.1505405208393326e-06,1.650298643381708e-06
811,Georgia,GEO,Summer,2008,3324735.8789999997,3848449.0,0.863915795428236,3,2,2,7,9,4,2,15,4.511636576831372e-06,3.897674101956398e-06
812,Hungary,HUN,Summer,2008,15772330.08,10038188.0,1.5712327842435307,3,5,2,10,9,10,2,21,1.3314456325402999e-06,2.0920110282851844e-06
813,India,IND,Summer,2008,993503.7725,1206734806.0,0.0008232991768864252,1,0,2,3,3,0,2,5,5.032693522057059e-06,4.1434124342312205e-09
814,Ireland,IRL,Summer,2008,61353106.56,4489544.0,13.665776871771387,0,1,2,3,0,2,2,4,6.519637267410767e-08,8.909590818132086e-07
815,Iceland,ISL,Summer,2008,56943370.45,317414.0,179.39779105521495,0,1,0,1,0,2,0,2,3.512261364571194e-08,6.300919304126472e-06
816,Israel,ISR,Summer,2008,30173361.59,7308800.0,4.128360550295534,0,0,1,1,0,0,1,1,3.3141816069026205e-08,1.3682136602451838e-07
817,Italy,ITA,Summer,2008,40944912.42,58826731.0,0.6960256285531148,8,9,10,27,24,18,10,52,1.2699990530349752e-06,8.839518891505292e-07
818,Jamaica,JAM,Summer,2008,5056258.245,2711373.0,1.8648331472652417,5,4,2,11,15,8,2,25,4.9443677100001444e-06,9.220420797876205e-06
819,Japan,JPN,Summer,2008,39876303.97,128063000.0,0.3113803672411235,9,8,8,25,27,16,8,51,1.2789550415296425e-06,3.982414905163865e-07
820,Kazakhstan,KAZ,Summer,2008,8458017.154,15776938.0,0.5361000438741661,2,3,4,9,6,6,4,16,1.8916963289005884e-06,1.0141384849202043e-06
821,Kenya,KEN,Summer,2008,915998.9157,39186895.0,0.023375133847680456,6,4,6,16,18,8,6,32,3.493453916978256e-05,8.16599529000703e-07
822,Kyrgyz Republic,KGZ,Summer,2008,966393.6272,5318700.0,0.18169733716885705,0,1,2,3,0,2,2,4,4.139100142443489e-06,7.520634741572189e-07
823,"Korea, Rep.",KOR,Summer,2008,21350427.98,49054708.0,0.43523708223887503,13,11,8,32,39,22,8,69,3.231785333045113e-06,1.4065928187769458e-06
824,Lithuania,LTU,Summer,2008,14944996.649999999,3198231.0,4.6728946877195545,0,3,2,5,0,6,2,8,5.35296205636821e-07,2.501382795676735e-06
825,Morocco,MAR,Summer,2008,2889220.9469999997,31634992.0,0.09132990920307486,0,1,1,2,0,2,1,3,1.038342188095731e-06,9.483169776050521e-08
826,Moldova,MDA,Summer,2008,2110561.99,2868833.0,0.7356865979999534,0,0,1,1,0,0,1,1,4.7380745258280706e-07,3.485737928976695e-07
827,Mexico,MEX,Summer,2008,10119836.209999999,109684489.0,0.09226314770906212,2,0,2,4,6,0,2,8,7.905266284937235e-07,7.293647509266329e-08
828,Norway,NOR,Summer,2008,96944095.61,4768212.0,20.331330823797263,3,5,1,9,9,10,1,20,2.063044672721353e-07,4.194444374537038e-06
829,New Zealand,NZL,Summer,2008,31252962.56,4259800.0,7.336720634771585,3,2,4,9,9,4,4,17,5.439484326442044e-07,3.9907976900323955e-06
830,Panama,PAN,Summer,2008,7197110.786,3495276.0,2.059096559470554,1,0,0,1,3,0,0,3,4.1683393367178324e-07,8.583013186941461e-07
831,Poland,POL,Summer,2008,13996025.15,38125759.0,0.36710154806360706,4,5,2,11,12,10,2,24,1.7147725688389464e-06,6.294956645977855e-07
832,"Korea, Dem. People's Rep.",PRK,Summer,2008,0.0,24469047.0,0.0,2,2,2,6,6,4,2,12,0.0,4.904155033091399e-07
833,Romania,ROU,Summer,2008,10435043.98,20537875.0,0.5080878123953915,4,1,4,9,12,2,4,18,1.724956793138499e-06,8.764295235023097e-07
834,Russian Federation,RUS,Summer,2008,11635272.46,142742366.0,0.0815123973775242,24,13,23,60,72,26,23,121,1.0399412683800615e-05,8.476810591748213e-07
835,Singapore,SGP,Summer,2008,40007469.26,4839396.0,8.26703771710354,0,1,0,1,0,2,0,2,4.9990665168107165e-08,4.1327471444783605e-07
836,Serbia,SRB,Summer,2008,7101040.141000001,7350222.0,0.9660987302152235,0,1,2,3,0,2,2,4,5.632977592824454e-07,5.442012499758511e-07
837,Slovak Republic,SVK,Summer,2008,18753584.94,5379233.0,3.4862934808735746,3,3,0,6,9,6,0,15,7.998470717993825e-07,2.788501632110005e-06
838,Sweden,SWE,Summer,2008,56152552.34,9219637.0,6.090538308612367,0,4,1,5,0,8,1,9,1.6027766548358467e-07,9.761772616427306e-07
839,Thailand,THA,Summer,2008,4327797.6,67328239.0,0.06427908503592378,2,2,2,6,6,4,2,12,2.7727729226523905e-06,1.7823130648047992e-07
840,Tajikistan,TJK,Summer,2008,704655.3136999999,7324627.0,0.09620357646880857,0,1,1,2,0,2,1,3,4.257400663379118e-06,4.095771702777493e-07
841,Trinidad and Tobago,TTO,Summer,2008,20011148.270000003,1392803.0,14.367536737069063,1,1,0,2,3,2,0,5,2.4986072425917813e-07,3.589883134944425e-06
842,Tunisia,TUN,Summer,2008,4200315.819999999,10680380.0,0.3932740052320235,1,0,0,1,3,0,0,3,7.142320074398597e-07,2.8088888223078206e-07
843,Turkiye,TUR,Summer,2008,10802780.61,71320726.0,0.15146761980521622,1,1,3,5,3,2,3,8,7.405500758382985e-07,1.1216935733379943e-07
844,Ukraine,UKR,Summer,2008,4066547.852,46258189.0,0.08790979370160816,7,4,11,22,21,8,11,40,9.836352959753639e-06,8.647117594681452e-07
845,United States,USA,Summer,2008,48570045.980000004,304093966.0,0.1597205186899368,36,39,37,112,108,78,37,223,4.591307162686774e-06,7.333259614891537e-07
846,Uzbekistan,UZB,Summer,2008,1082286.0250000001,27302800.0,0.039640111087507514,0,1,3,4,0,2,3,5,4.619850838413994e-06,1.8313140044244546e-07
847,"Venezuela, RB",VEN,Summer,2008,11310778.17,27933833.0,0.4049132165285015,0,0,1,1,0,0,1,1,8.841124677454443e-08,3.5798882308775886e-08
848,Australia,AUS,Winter,2010,52134308.85,22031750.0,2.3663262723115506,2,1,0,3,6,2,0,8,1.5344981407574563e-07,3.631123265287596e-07
849,Austria,AUT,Winter,2010,46903761.59,8363404.0,5.608214261800578,4,6,6,16,12,12,6,30,6.396075492247103e-07,3.5870561795173354e-06
850,Belarus,BLR,Winter,2010,6033686.239,9483836.0,0.636207357339372,1,1,1,3,3,2,1,6,9.944169720357248e-07,6.326553938722686e-07
851,Canada,CAN,Winter,2010,47562083.43,34004889.0,1.3986836842784578,14,7,5,26,42,14,5,61,1.2825342289678582e-06,1.7938597005859952e-06
852,China,CHN,Winter,2010,4550453.108,1337705000.0,0.003401686551220187,5,2,4,11,15,4,4,23,5.054441712532861e-06,1.7193626397449364e-08
853,Czechia,CZE,Winter,2010,19960068.490000002,10474410.0,1.905603130868469,2,0,4,6,6,0,4,10,5.01000284894313e-07,9.547077114605977e-07
854,Estonia,EST,Winter,2010,14663044.610000001,1331475.0,11.012632313787343,0,1,0,1,0,2,0,2,1.3639732082899254e-07,1.5020935428753826e-06
855,Finland,FIN,Winter,2010,46505303.18,5363352.0,8.670939960681306,0,1,4,5,0,2,4,6,1.290175440159339e-07,1.1187033780367203e-06
856,France,FRA,Winter,2010,40676064.79,65030575.0,0.6254913906266398,2,3,6,11,6,6,6,18,4.425206836730481e-07,2.7679287781170626e-07
857,United Kingdom,GBR,Winter,2010,39693193.870000005,62766365.0,0.632395931642688,1,0,0,1,3,0,0,3,7.557970794250929e-08,4.779629981758542e-08
858,Italy,ITA,Winter,2010,36035645.0,59277417.0,0.607915236927412,1,1,3,5,3,2,3,8,2.220024090036407e-07,1.3495864706790446e-07
859,Japan,JPN,Winter,2010,44968156.230000004,128070000.0,0.35112170086671357,0,3,2,5,0,6,2,8,1.7790366941179787e-07,6.24658389943e-08
860,Kazakhstan,KAZ,Winter,2010,9070488.252999999,16321872.0,0.5557259763463406,0,1,0,1,0,2,0,2,2.2049529685885592e-07,1.225349641266639e-07
861,"Korea, Rep.",KOR,Winter,2010,23087225.64,49554112.0,0.4658992908600602,6,6,2,14,18,12,2,32,1.3860478733554752e-06,6.457587212944104e-07
862,Norway,NOR,Winter,2010,87693790.07000001,4889252.0,17.936033992520738,9,8,6,23,27,16,6,49,5.587624843319764e-07,1.0021982912723665e-05
863,Poland,POL,Winter,2010,12504250.190000001,38042794.0,0.3286890597467684,1,3,2,6,3,6,2,11,8.797008883265154e-07,2.8914805784243923e-07
864,Russian Federation,RUS,Winter,2010,10674996.09,142849468.0,0.07472898737011748,3,5,7,15,9,10,7,26,2.4355980817975177e-06,1.8200977829332903e-07
865,Slovak Republic,SVK,Winter,2010,16908847.96,5391428.0,3.1362466418915362,1,1,1,3,3,2,1,6,3.5484380805799144e-07,1.1128777014178804e-06
866,Sweden,SWE,Winter,2010,52869044.29,9378126.0,5.637484961281177,5,2,4,11,15,4,4,23,4.3503718118752473e-07,2.4525155665428255e-06
867,United States,USA,Winter,2010,48650643.129999995,309327143.0,0.1572789334235696,9,15,13,37,27,30,13,70,1.4388299002122566e-06,2.262976320833248e-07
868,Afghanistan,AFG,Summer,2012,663141.0528000001,30466479.0,0.021766251781178917,0,0,1,1,0,0,1,1,1.5079748053263637e-06,3.2822959292407896e-08
869,Argentina,ARG,Summer,2012,13082664.33,41733271.0,0.3134828403457759,1,1,2,4,3,2,2,7,5.350592068580575e-07,1.6773187991902193e-07
870,Armenia,ARM,Summer,2012,3643715.1829999997,2914421.0,1.2502363876049478,0,1,1,2,0,2,1,3,8.233354829698829e-07,1.0293639800152415e-06
871,Australia,AUS,Summer,2012,68044714.82,22733465.0,2.9931519379029985,8,15,12,35,24,30,12,66,9.699504241378787e-07,2.9032089916781275e-06
872,Azerbaijan,AZE,Summer,2012,7496294.648,9295784.0,0.8064187644635461,2,2,5,9,6,4,5,15,2.0009885822727068e-06,1.613634740222019e-06
873,Belgium,BEL,Summer,2012,44670560.68,11106932.0,4.021863164373384,0,1,2,3,0,2,2,4,8.954443237581498e-08,3.6013545414701376e-07
874,Belarus,BLR,Summer,2012,6953132.515000001,9446836.0,0.7360276514803475,2,5,3,10,6,10,3,19,2.732581316264472e-06,2.011255408689216e-06
875,Brazil,BRA,Summer,2012,12327317.440000001,199977707.0,0.06164345828807809,3,5,9,17,9,10,9,28,2.2713781920748524e-06,1.4001560683961638e-07
876,Brunei Darussalam,BRN,Summer,2012,46842960.26,406634.0,115.19686071504104,1,0,0,1,3,0,0,3,6.40437748457531e-08,7.377641810571669e-06
877,Canada,CAN,Summer,2012,52669089.96,34714222.0,1.5172193679005683,2,6,10,18,6,12,10,28,5.316211087236336e-07,8.065858425402707e-07
878,China,CHN,Summer,2012,6300615.118,1354190000.0,0.004652681764006528,38,31,22,91,114,62,22,198,3.1425503112282e-05,1.4621286525524483e-07
879,Cameroon,CMR,Summer,2012,1433724.035,21032684.0,0.06816648008404443,0,0,1,1,0,0,1,1,6.974842965508353e-07,4.754504940976625e-08
880,Colombia,COL,Summer,2012,8101829.092,45782417.0,0.17696376956245014,1,3,5,9,3,6,5,14,1.7280048543388848e-06,3.0579425284602165e-07
881,Cuba,CUB,Summer,2012,6467337.914,11309290.0,0.5718606485464605,5,3,7,15,15,6,7,28,4.329447505655725e-06,2.4758406584321384e-06
882,Cyprus,CYP,Summer,2012,28993349.61,1156556.0,25.06869499617831,0,1,0,1,0,2,0,2,6.898133630307367e-08,1.7292720802105561e-06
883,Czechia,CZE,Summer,2012,19870801.21,10510785.0,1.8905154286763548,4,3,4,11,12,6,4,22,1.1071521358146584e-06,2.093088194649591e-06
884,Dominican Republic,DOM,Summer,2012,6049471.741,10030882.0,0.6030847278434738,1,1,0,2,3,2,0,5,8.265184488940982e-07,4.984606538089073e-07
885,"Egypt, Arab Rep.",EGY,Summer,2012,3059135.428,91240376.0,0.03352830799382063,0,3,1,4,0,6,1,7,2.28822821504717e-06,7.672042035425193e-08
886,Spain,ESP,Summer,2012,28322946.59,46773055.0,0.6055398047016599,4,10,6,20,12,20,6,38,1.3416683140382252e-06,8.124335688571123e-07
887,Estonia,EST,Summer,2012,17403205.330000002,1322696.0,13.157373523470246,0,1,1,2,0,2,1,3,1.723820378553219e-07,2.268094860799458e-06
888,Ethiopia,ETH,Summer,2012,458550.92079999996,94451280.0,0.004854893663696246,3,2,3,8,9,4,3,16,3.489252616064096e-05,1.693995041676513e-07
889,Finland,FIN,Summer,2012,47708061.28,5413971.0,8.812027489618988,0,2,1,3,0,4,1,5,1.0480409108755969e-07,9.235365316881084e-07
890,France,FRA,Summer,2012,40870852.36,65662240.0,0.6224407263596247,11,11,13,35,33,22,13,68,1.6637773883705714e-06,1.0356028061180977e-06
891,Gabon,GAB,Summer,2012,9348515.572,1836705.0,5.089829652557161,0,1,0,1,0,2,0,2,2.1393770856950334e-07,1.0889064928771904e-06
892,United Kingdom,GBR,Summer,2012,42485586.07,63700215.0,0.6669614234426053,29,18,18,65,87,36,18,141,3.3187726248541308e-06,2.213493313955063e-06
893,Georgia,GEO,Summer,2012,4421818.242000001,3728874.0,1.18583203454984,1,2,3,6,3,4,3,10,2.2615131271150967e-06,2.681774712688066e-06
894,"Hong Kong SAR, China",HKG,Summer,2012,36730876.7,7150100.0,5.137113704703431,0,0,1,1,0,0,1,1,2.7225051233258474e-08,1.3985818380162516e-07
895,Hungary,HUN,Summer,2012,12984836.57,9920362.0,1.308907534825846,8,4,6,18,24,8,6,38,2.926490433294687e-06,3.830505378735171e-06
896,India,IND,Summer,2012,1434018.198,1274487215.0,0.0011251726820970896,0,2,4,6,0,4,4,8,5.578729761698603e-06,6.277034328665274e-09
897,Ireland,IRL,Summer,2012,49054697.43,4599533.0,10.665147403008088,1,1,4,6,3,2,4,9,1.8346866806879824e-07,1.9567203887872965e-06
898,Italy,ITA,Summer,2012,35051521.269999996,59539717.0,0.588708227652476,8,9,11,28,24,18,11,53,1.512059907236089e-06,8.901621080933253e-07
899,Jamaica,JAM,Summer,2012,5365242.2930000005,2759817.0,1.9440572664781761,4,5,3,12,12,10,3,25,4.659621809180426e-06,9.058571637177393e-06
900,Japan,JPN,Summer,2012,49145280.43,127629000.0,0.3850635860972036,7,14,17,38,21,28,17,66,1.342957033158189e-06,5.171238511623534e-07
901,Kazakhstan,KAZ,Summer,2012,12386699.27,16792090.0,0.7376508385793549,3,1,7,11,9,2,7,18,1.4531716325425893e-06,1.0719332733447712e-06
902,Kenya,KEN,Summer,2012,1289780.822,43725806.0,0.029497016521547938,2,4,7,13,6,8,7,21,1.6281836139753053e-05,4.802655896154321e-07
903,"Korea, Rep.",KOR,Summer,2012,25466760.52,50199853.0,0.5073074719959837,13,9,8,30,39,18,8,65,2.5523466146765337e-06,1.2948245087490594e-06
904,Lithuania,LTU,Summer,2012,14367709.42,2987773.0,4.808835684638693,2,0,3,5,6,0,3,9,6.264046506586434e-07,3.0122770371109185e-06
905,Morocco,MAR,Summer,2012,2907449.219,33352169.0,0.08717421703517993,0,0,1,1,0,0,1,1,3.4394409830619297e-07,2.9983057473713326e-08
906,Mexico,MEX,Summer,2012,10376057.67,115755909.0,0.08963739095167919,1,3,4,8,3,6,4,13,1.252884324032482e-06,1.123052819705299e-07
907,Montenegro,MNE,Summer,2012,6586721.279,620601.0,10.613455793658083,0,1,0,1,0,2,0,2,3.0364120710200164e-07,3.222682528710073e-06
908,Norway,NOR,Summer,2012,101524141.9,5018573.0,20.229683198789775,2,1,1,4,6,2,1,9,8.864886549708429e-08,1.7933384649381407e-06
909,New Zealand,NZL,Summer,2012,39973380.76,4408100.0,9.068165595154374,6,2,5,13,18,4,5,27,6.754494988079162e-07,6.125087906354211e-06
910,Poland,POL,Summer,2012,13010923.39,38063164.0,0.34182453644683874,3,2,6,11,9,4,6,19,1.4603114191420966e-06,4.991702739162725e-07
911,"Korea, Dem. People's Rep.",PRK,Summer,2012,0.0,24887770.0,0.0,4,0,3,7,12,0,3,15,0.0,6.027056662770509e-07
912,Qatar,QAT,Summer,2012,98041362.24000001,1905660.0,51.447457699694596,0,1,1,2,0,2,1,3,3.059933003232004e-08,1.5742577374767796e-06
913,Romania,ROU,Summer,2012,8930729.912,20058035.0,0.44524450735079485,2,4,1,7,6,8,1,15,1.6795939579188116e-06,7.478299843429329e-07
914,Russian Federation,RUS,Summer,2012,15420875.0,143201721.0,0.10768638038924128,19,21,26,66,57,42,26,125,8.10589541773732e-06,8.728945373498689e-07
915,Singapore,SGP,Summer,2012,55546488.54,5312437.0,10.45593360260084,0,0,2,2,0,0,2,2,3.600587638514296e-08,3.7647505278650836e-07
916,Serbia,SRB,Summer,2012,6015945.227999999,7199077.0,0.8356550746713779,1,1,2,4,3,2,2,7,1.1635744234205985e-06,9.723468716892458e-07
917,Slovak Republic,SVK,Summer,2012,17498353.9,5407579.0,3.2358942698756685,0,1,3,4,0,2,3,5,2.8574116334451323e-07,9.246281931341179e-07
918,Sweden,SWE,Summer,2012,58037821.32,9519374.0,6.096810706250222,1,4,3,8,3,8,3,14,2.4122201146746973e-07,1.4706849420980834e-06
919,Thailand,THA,Summer,2012,5748631.241,69157023.0,0.08312433056871173,0,2,2,4,0,4,2,6,1.0437267148407789e-06,8.675908446782043e-08
920,Tajikistan,TJK,Summer,2012,959361.905,7956382.0,0.12057765765897113,0,0,1,1,0,0,1,1,1.0423595045709053e-06,1.2568526749972537e-07
921,Trinidad and Tobago,TTO,Summer,2012,18961233.59,1430377.0,13.25610911668742,1,1,2,4,3,2,2,7,3.691742927365097e-07,4.893814707591075e-06
922,Tunisia,TUN,Summer,2012,4233894.568,11174383.0,0.37889291677222803,2,0,1,3,6,0,1,7,1.6533241174464692e-06,6.264327972291624e-07
923,Turkiye,TUR,Summer,2012,11697480.51,75277439.0,0.15539158432315955,1,1,1,3,3,2,1,6,5.129309679012238e-07,7.970515575058286e-08
924,Uganda,UGA,Summer,2012,796711.135,34273295.0,0.023245828421224163,1,0,0,1,3,0,0,3,3.765480195027022e-06,8.753170653711585e-08
925,Ukraine,UKR,Summer,2012,4004804.443,45593342.0,0.08783748388087015,5,4,10,19,15,8,10,33,8.240102724037055e-06,7.23789890199319e-07
926,United States,USA,Summer,2012,51784418.57,313877662.0,0.16498280967187784,47,27,30,104,141,54,30,225,4.344936299629481e-06,7.168397985582038e-07
927,Uzbekistan,UZB,Summer,2012,2267623.275,29774500.0,0.07615991116559472,0,0,3,3,0,0,3,3,1.3229710741966169e-06,1.0075735948546575e-07
928,"Venezuela, RB",VEN,Summer,2012,12937927.600000001,29470426.0,0.4390139321365766,1,0,0,1,3,0,0,3,2.31876394176143e-07,1.0179696757691931e-07
929,Australia,AUS,Winter,2014,62513411.22,23475686.0,2.6629002969284903,0,2,1,3,0,4,1,5,7.998283732115938e-08,2.1298632125169846e-07
930,Austria,AUT,Winter,2014,51786377.17,8546356.0,6.059468757210675,4,8,5,17,12,16,5,33,6.372332223911001e-07,3.861294802135553e-06
931,Belarus,BLR,Winter,2014,8341399.6790000005,9448515.0,0.8828265266023285,5,0,1,6,15,0,1,16,1.9181433111616757e-06,1.6933877969183518e-06
932,Canada,CAN,Winter,2014,50955998.32,35437435.0,1.43791440661549,10,10,5,25,30,20,5,55,1.0793626229164222e-06,1.5520310654538062e-06
933,China,CHN,Winter,2014,7636116.601,1371860000.0,0.005566250638549123,3,4,2,9,9,8,2,19,2.4881757302542793e-06,1.3849809747350314e-08
934,Czechia,CZE,Winter,2014,19890919.91,10525347.0,1.8898113202348579,2,4,3,9,6,8,3,17,8.546613267219173e-07,1.6151486502060218e-06
935,Finland,FIN,Winter,2014,50327240.29,5461512.0,9.214891460460034,1,3,1,5,3,6,1,10,1.9869955003248997e-07,1.830994786791643e-06
936,France,FRA,Winter,2014,43068548.72,66312067.0,0.6494828267078449,4,4,7,15,12,8,7,27,6.269075880762578e-07,4.0716571238836516e-07
937,United Kingdom,GBR,Winter,2014,47447588.93,64602298.0,0.7344566741263601,1,1,3,5,3,2,3,8,1.6860709217074227e-07,1.2383460414983999e-07
938,Italy,ITA,Winter,2014,35565721.38,60789140.0,0.5850670264458422,0,2,6,8,0,4,6,10,2.811696097249244e-07,1.6450306748869945e-07
939,Japan,JPN,Winter,2014,38475395.25,127276000.0,0.30229890356390837,1,4,3,8,3,8,3,14,3.638689065838771e-07,1.0999717150130425e-07
940,Kazakhstan,KAZ,Winter,2014,12807260.69,17288285.0,0.7408057357916068,0,0,1,1,0,0,1,1,7.808070938860541e-08,5.7842637369756454e-08
941,"Korea, Rep.",KOR,Winter,2014,29249575.22,50746659.0,0.5763842545772323,3,3,2,8,9,6,2,17,5.812050216844141e-07,3.3499742318011514e-07
942,Norway,NOR,Winter,2014,97019182.75,5137232.0,18.885497627905455,11,6,9,26,33,12,9,54,5.565909593275769e-07,1.0511497242094575e-05
943,Poland,POL,Winter,2014,14182137.5,38011735.0,0.3730989258974893,4,1,1,6,12,2,1,15,1.057668493201395e-06,3.9461497876905643e-07
944,Russian Federation,RUS,Winter,2014,14095648.440000001,143819667.0,0.09800918562827712,10,10,9,29,30,20,9,59,4.185688955789536e-06,4.10235965850206e-07
945,Slovak Republic,SVK,Winter,2014,18719988.14,5418649.0,3.4547334843057746,1,0,0,1,3,0,0,3,1.602565117864439e-07,5.536435373466707e-07
946,Sweden,SWE,Winter,2014,60020360.46,9696110.0,6.190148467787598,2,7,6,15,6,14,6,26,4.331863354490757e-07,2.68148773064662e-06
947,Ukraine,UKR,Winter,2014,3104643.3109999998,45272155.0,0.06857732553265909,1,0,1,2,3,0,1,4,1.2883927715070133e-06,8.83545305055613e-08
948,United States,USA,Winter,2014,55123849.79,318386329.0,0.17313510276378732,9,9,10,28,27,18,10,55,9.977532449117429e-07,1.7274611059069688e-07
949,Argentina,ARG,Summer,2016,12790242.469999999,43590368.0,0.2934190064649144,3,1,0,4,9,2,0,11,8.600306073790954e-07,2.5234932634659106e-07
950,Armenia,ARM,Summer,2016,3679951.972,2865835.0,1.2840767078355872,1,3,0,4,3,6,0,9,2.445684092748806e-06,3.140445978222752e-06
951,Australia,AUS,Summer,2016,49875565.14,24190907.0,2.0617484553183556,8,11,10,29,24,22,10,56,1.1227942950181877e-06,2.3149194033940108e-06
952,Austria,AUT,Summer,2016,45307587.86,8736668.0,5.1859115923828165,0,0,1,1,0,0,1,1,2.207135818154765e-08,1.1446011225332129e-07
953,Azerbaijan,AZE,Summer,2016,3880738.731,9757812.0,0.397705831081804,1,7,10,18,3,14,10,27,6.9574382280155615e-06,2.767013752673243e-06
954,Burundi,BDI,Summer,2016,242065.6705,10903327.0,0.022201083256514275,0,1,0,1,0,2,0,2,8.262220726585846e-06,1.8343025023463022e-07
955,Belgium,BEL,Summer,2016,42012622.72,11331422.0,3.7076214017975855,2,2,2,6,6,4,2,12,2.856284426700986e-07,1.059002127005772e-06
956,Belarus,BLR,Summer,2016,5039681.886,9469379.0,0.5322082774382565,1,4,4,9,3,8,4,15,2.9763783388132685e-06,1.584053188704349e-06
957,Brazil,BRA,Summer,2016,8680768.792000001,206859578.0,0.04196454849192432,7,6,6,19,21,12,6,39,4.492689637805066e-06,1.8853369216483656e-07
958,Brunei Darussalam,BRN,Summer,2016,26762945.650000002,425994.0,62.82470093475496,1,1,0,2,3,2,0,5,1.868254737497477e-07,1.1737254515321812e-05
959,Canada,CAN,Summer,2016,42315603.71,36109487.0,1.1718694234011133,4,3,15,22,12,6,15,33,7.798541697799636e-07,9.13887256277e-07
960,China,CHN,Summer,2016,8094363.367,1387790000.0,0.005832556342818438,26,18,26,70,78,36,26,140,1.7295986559087224e-05,1.0087981611050663e-07
961,Cote d'Ivoire,CIV,Summer,2016,1980878.142,24213622.0,0.08180841932693919,1,0,1,2,3,0,1,4,2.0193064455551956e-06,1.6519626844757055e-07
962,Colombia,COL,Summer,2016,5938463.856000001,47625955.0,0.12468965411822189,3,2,3,8,9,4,3,16,2.6942994666599176e-06,3.3595126858873484e-07
963,Cuba,CUB,Summer,2016,8055889.907,11342012.0,0.7102699156904436,5,2,4,11,15,4,4,23,2.8550539127917603e-06,2.0278589019302747e-06
964,Czechia,CZE,Summer,2016,18575232.029999997,10566332.0,1.7579640721113057,1,2,7,10,3,4,7,14,7.536917965487186e-07,1.3249630997776712e-06
965,Dominican Republic,DOM,Summer,2016,7191076.572,10527592.0,0.683069458998791,0,0,1,1,0,0,1,1,1.3906123651828637e-07,9.498848359624879e-08
966,"Egypt, Arab Rep.",EGY,Summer,2016,3331612.461,99784030.0,0.033388233177192785,0,0,3,3,0,0,3,3,9.0046487552743e-07,3.006493123198171e-08
967,Spain,ESP,Summer,2016,26537159.49,46484062.0,0.570887275083662,7,4,6,17,21,8,6,35,1.3189052887589215e-06,7.52946246393011e-07
968,Estonia,EST,Summer,2016,18295342.93,1315790.0,13.904455065017974,0,0,1,1,0,0,1,1,5.46587185507323e-08,7.599996960001216e-07
969,Ethiopia,ETH,Summer,2016,705616.305,105293228.0,0.006701440523791331,1,2,5,8,3,4,5,12,1.700640973708792e-05,1.1396744337632046e-07
970,Finland,FIN,Summer,2016,43814026.510000005,5495303.0,7.9729955764040685,0,0,1,1,0,0,1,1,2.2823741154485366e-08,1.8197358726170332e-07
971,France,FRA,Summer,2016,37062533.57,66724104.0,0.5554594419132253,10,18,14,42,30,36,14,80,2.158514065124663e-06,1.1989670179759926e-06
972,United Kingdom,GBR,Summer,2016,41146077.36,65611593.0,0.6271159634852944,27,23,17,67,81,46,17,144,3.4997260793562074e-06,2.19473409219008e-06
973,Georgia,GEO,Summer,2016,4062169.888,3727505.0,1.089782545697457,2,1,4,7,6,2,4,12,2.954086197982274e-06,3.219311577046845e-06
974,Hungary,HUN,Summer,2016,13104699.549999999,9814023.0,1.3353035294496456,8,3,4,15,24,6,4,34,2.5944890892214314e-06,3.4644304379559737e-06
975,India,IND,Summer,2016,1714280.3550000002,1338636340.0,0.001280616926177277,0,1,1,2,0,2,1,3,1.7500054709546033e-06,2.241086627007302e-09
976,Ireland,IRL,Summer,2016,62895911.12,4755335.0,13.226389122953481,0,2,0,2,0,4,0,4,6.359713896771992e-08,8.411605070936117e-07
977,Israel,ISR,Summer,2016,37690473.95,8546000.0,4.410305868242453,0,0,2,2,0,0,2,2,5.306380606020477e-08,2.3402761525860052e-07
978,Italy,ITA,Summer,2016,30960731.51,60627498.0,0.5106714367464084,8,12,8,28,24,24,8,56,1.808742793493512e-06,9.23673281058044e-07
979,Jamaica,JAM,Summer,2016,5022704.716999999,2802695.0,1.792098218678807,6,3,2,11,18,6,2,26,5.176493834487145e-06,9.27678537978624e-06
980,Jordan,JOR,Summer,2016,4003404.749,9964656.0,0.4017604570594308,1,0,0,1,3,0,0,3,7.493621524901678e-07,3.010640808874887e-07
981,Japan,JPN,Summer,2016,39375473.160000004,127076000.0,0.30985766911139795,12,8,21,41,36,16,21,73,1.8539459755408813e-06,5.744593786395543e-07
982,Kazakhstan,KAZ,Summer,2016,7714841.844,17794055.0,0.43356288625611195,2,5,10,17,6,10,10,26,3.3701274148893624e-06,1.4611621690502811e-06
983,Kenya,KEN,Summer,2016,1562076.142,47894670.0,0.03261482210859789,6,6,1,13,18,12,1,31,1.984538343970175e-05,6.47253650562787e-07
984,"Korea, Rep.",KOR,Summer,2016,29288870.439999998,51217803.0,0.5718494102529154,9,3,9,21,27,6,9,42,1.4339917985584152e-06,8.200273643131472e-07
985,Lithuania,LTU,Summer,2016,15008313.24,2868231.0,5.232602687858823,0,1,3,4,0,2,3,5,3.331486969950795e-07,1.7432347673531176e-06
986,Morocco,MAR,Summer,2016,3132944.58,35107264.0,0.08923921214709298,0,0,1,1,0,0,1,1,3.191885379600299e-07,2.848413365393555e-08
987,Mexico,MEX,Summer,2016,8875062.256,121519221.0,0.07303422605054388,0,3,2,5,0,6,2,8,9.014021275841291e-07,6.583320674842048e-08
988,Norway,NOR,Summer,2016,70460560.53,5234519.0,13.460751700395013,0,0,4,4,0,0,4,4,5.6769346850383335e-08,7.641580821466118e-07
989,New Zealand,NZL,Summer,2016,40058196.16,4714100.0,8.497527875946627,4,9,5,18,12,18,5,35,8.73728808461654e-07,7.4245349059205365e-06
990,Poland,POL,Summer,2016,12378759.44,37970087.0,0.3260134600165651,2,3,6,11,6,6,6,18,1.4541037078267998e-06,4.7405738101153153e-07
991,"Korea, Dem. People's Rep.",PRK,Summer,2016,0.0,25389611.0,0.0,2,3,2,7,6,6,2,14,0.0,5.514066363600451e-07
992,Qatar,QAT,Summer,2016,58467235.57,2595166.0,22.529285436846816,0,1,0,1,0,2,0,2,3.420719280639661e-08,7.706636107285623e-07
993,Romania,ROU,Summer,2016,9404341.874,19702267.0,0.4773228316315072,1,1,2,4,3,2,2,7,7.443370406761544e-07,3.5528906394375833e-07
994,Russian Federation,RUS,Summer,2016,8704898.438000001,144342397.0,0.06030728752550785,19,17,20,56,57,34,20,111,1.2751441132896534e-05,7.690048267661788e-07
995,Singapore,SGP,Summer,2016,56860413.24,5607283.0,10.140457194687695,1,0,0,1,3,0,0,3,5.276078433228073e-08,5.350184750796419e-07
996,Serbia,SRB,Summer,2016,5765200.762,7058322.0,0.8167948078877671,2,4,2,8,6,8,2,16,2.775271956782552e-06,2.266827724776512e-06
997,Slovak Republic,SVK,Summer,2016,16563440.5,5430798.0,3.049909147790067,2,2,0,4,6,4,0,10,6.037393016263741e-07,1.8413500189106646e-06
998,Sweden,SWE,Summer,2016,51965157.15,9923085.0,5.236794520050972,2,6,3,11,6,12,3,21,4.041169343408788e-07,2.116277347216113e-06
999,Thailand,THA,Summer,2016,5854461.088,70607037.0,0.08291611341798694,2,2,2,6,6,4,2,12,2.049718978335449e-06,1.6995473128266238e-07
1000,Tajikistan,TJK,Summer,2016,801391.2831,8725318.0,0.09184665625940511,1,0,0,1,3,0,0,3,3.7434896825869903e-06,3.4382701008719684e-07
1001,Trinidad and Tobago,TTO,Summer,2016,15991108.790000001,1469330.0,10.88326569933235,0,0,1,1,0,0,1,1,6.253475059999263e-08,6.805823062212028e-07
1002,Tunisia,TUN,Summer,2016,3796167.92,11685667.0,0.32485675999495794,0,0,3,3,0,0,3,3,7.902706263847254e-07,2.567247552065278e-07
1003,Turkiye,TUR,Summer,2016,10734379.97,81019394.0,0.13249148679142184,1,3,4,8,3,6,4,13,1.2110620302552975e-06,1.6045540898516225e-07
1004,Ukraine,UKR,Summer,2016,2187730.469,45004673.0,0.048611184642981406,2,5,4,11,6,10,4,20,9.141893977982532e-06,4.4439829615026867e-07
1005,United States,USA,Summer,2016,57866744.93,323071755.0,0.17911421854256496,46,37,38,121,138,74,38,250,4.3202706546293374e-06,7.738219021963093e-07
1006,Uzbekistan,UZB,Summer,2016,2704677.188,31847900.0,0.08492482041202089,4,2,7,13,12,4,7,23,8.503787476762643e-06,7.221826242860597e-07
1007,"Venezuela, RB",VEN,Summer,2016,0.0,30741464.0,0.0,0,2,1,3,0,4,1,5,0.0,1.626467757033302e-07
1008,Australia,AUS,Winter,2018,57207871.51,24966643.0,2.291372192488994,0,2,1,3,0,4,1,5,8.740055988844114e-08,2.0026721253634299e-07
1009,Austria,AUT,Winter,2018,51466556.559999995,8840521.0,5.821665551159258,5,3,6,14,15,6,6,27,5.246125213083423e-07,3.0541186430075785e-06
1010,Belgium,BEL,Winter,2018,47544981.15,11427054.0,4.160738292651807,0,1,0,1,0,2,0,2,4.206542839275056e-08,1.7502323871051978e-07
1011,Belarus,BLR,Winter,2018,6360062.473,9438785.0,0.6738221575128579,2,1,0,3,6,2,0,8,1.257849279619804e-06,8.475667154194105e-07
1012,Canada,CAN,Winter,2018,46548638.41,37065084.0,1.2558622128038344,11,8,10,29,33,16,10,59,1.267491424353351e-06,1.5917945848982833e-06
1013,China,CHN,Winter,2018,9905342.004,1402760000.0,0.007061323393880636,1,6,2,9,3,12,2,17,1.716245637266741e-06,1.2118965468077219e-08
1014,Czechia,CZE,Winter,2018,23424480.459999997,10629928.0,2.2036349126729737,2,2,3,7,6,4,3,13,5.549749554616163e-07,1.2229621875143463e-06
1015,Spain,ESP,Winter,2018,30379721.11,46797754.0,0.6491704945925396,0,0,2,2,0,0,2,2,6.58333890807729e-08,4.273709375026844e-08
1016,Finland,FIN,Winter,2018,49987626.16,5515525.0,9.063076708019635,1,1,4,6,3,2,4,9,1.8004455685078686e-07,1.6317576296000834e-06
1017,France,FRA,Winter,2018,41557854.86,67158348.0,0.6188040072099451,5,4,6,15,15,8,6,29,6.978223514590714e-07,4.3181526740354004e-07
1018,United Kingdom,GBR,Winter,2018,43306308.3,66460344.0,0.6516112570828703,1,0,4,5,3,0,4,7,1.6163926861436028e-07,1.0532596701575905e-07
1019,Hungary,HUN,Winter,2018,16425101.299999999,9775564.0,1.6802203228376387,1,0,0,1,3,0,0,3,1.8264727536261832e-07,3.0688766397519365e-07
1020,Italy,ITA,Winter,2018,34622169.67,60421760.0,0.5730082948593355,3,2,5,10,9,4,5,18,5.19898093376769e-07,2.97905919986442e-07
1021,Japan,JPN,Winter,2018,39727116.6,126811000.0,0.3132781588348014,4,5,4,13,12,10,4,26,6.544648145946741e-07,2.0502953213837916e-07
1022,Kazakhstan,KAZ,Winter,2018,9812626.371000001,18276452.0,0.5368999612725709,0,0,1,1,0,0,1,1,1.0190951557631663e-07,5.4715214966230864e-08
1023,"Korea, Rep.",KOR,Winter,2018,33436923.060000002,51585058.0,0.6481900836478657,5,8,4,17,15,16,4,35,1.0467470328294018e-06,6.784910467678451e-07
1024,Liechtenstein,LIE,Winter,2018,175283631.8,38181.0,4590.86016081297,0,0,1,1,0,0,1,1,5.705039253984695e-09,2.6191037426992482e-05
1025,Norway,NOR,Winter,2018,82267809.32,5311916.0,15.487407805394511,14,14,11,39,42,28,11,81,9.845892417644361e-07,1.5248735108009992e-05
1026,New Zealand,NZL,Winter,2018,43250440.970000006,4900600.0,8.825539927763948,0,0,2,2,0,0,2,2,4.624230308743601e-08,4.0811329224992856e-07
1027,Poland,POL,Winter,2018,15504580.48,37974750.0,0.4082865714718333,1,0,1,2,3,0,1,4,2.5798827676503506e-07,1.0533314900032258e-07
1028,Slovak Republic,SVK,Winter,2018,19486393.68,5446771.0,3.577604727645058,1,2,0,3,3,4,0,7,3.5922501181860554e-07,1.2851651005705949e-06
1029,Sweden,SWE,Winter,2018,54589060.39,10175214.0,5.364905385773705,7,6,1,14,21,12,1,34,6.228354134893362e-07,3.3414530642795324e-06
1030,Ukraine,UKR,Winter,2018,3096561.768,44622518.0,0.06939459956069714,1,0,0,1,3,0,0,3,9.68816456691459e-07,6.723063005991728e-08
1031,United States,USA,Winter,2018,62823309.44,326838199.0,0.19221532131866875,9,8,6,23,27,16,6,49,7.799652778050147e-07,1.4992127649069564e-07
1032,Argentina,ARG,Summer,2020,8496424.141999999,45376763.0,0.18724174181397643,0,1,2,3,0,2,2,4,4.707862899907475e-07,8.815084496000739e-08
1033,Armenia,ARM,Summer,2020,4505867.364,2805608.0,1.606021712227795,0,2,2,4,0,4,2,6,1.331597118889361e-06,2.1385738848762906e-06
1034,Australia,AUS,Summer,2020,51720370.76,25655289.0,2.015973032305346,17,7,22,46,51,14,22,87,1.6821225123019595e-06,3.3911136218344687e-06
1035,Austria,AUT,Summer,2020,48809226.88,8916864.0,5.473810846503883,1,1,5,7,3,2,5,10,2.0487929515018778e-07,1.1214705080171684e-06
1036,Azerbaijan,AZE,Summer,2020,4229910.649,10093121.0,0.4190884711478244,0,3,4,7,0,6,4,10,2.364116131475287e-06,9.907738151558868e-07
1037,Belgium,BEL,Summer,2020,45517794.93,11538604.0,3.944826855137762,3,1,3,7,9,2,3,14,3.075720170876037e-07,1.2133183528960696e-06
1038,Belarus,BLR,Summer,2020,6542797.491,9379952.0,0.6975299544176772,1,3,3,7,3,6,3,12,1.8340778568351993e-06,1.2793242438767277e-06
1039,Brazil,BRA,Summer,2020,6794489.159,213196304.0,0.03186963859842523,7,6,8,21,21,12,8,41,6.0343020704788795e-06,1.92311026179891e-07
1040,Brunei Darussalam,BRN,Summer,2020,27179411.990000002,441725.0,61.530164672590416,0,1,0,1,0,2,0,2,7.358510922664004e-08,4.527703888165714e-06
1041,Canada,CAN,Summer,2020,43258263.870000005,38037204.0,1.1372619257188306,7,6,11,24,21,12,11,44,1.0171466920685736e-06,1.1567622057604445e-06
1042,China,CHN,Summer,2020,10408669.76,1411100000.0,0.007376280745517681,38,32,18,88,114,64,18,196,1.8830456198468153e-05,1.3889873148607468e-07
1043,Cote d'Ivoire,CIV,Summer,2020,2288119.498,26811790.0,0.0853400499556352,0,0,1,1,0,0,1,1,4.37040111267825e-07,3.729702492821255e-08
1044,Colombia,COL,Summer,2020,5307215.228,50930662.0,0.1042047171505448,0,4,1,5,0,8,1,9,1.6958046005968386e-06,1.7671083874778614e-07
1045,Cuba,CUB,Summer,2020,9499590.202,11300698.0,0.8406197742829691,7,3,5,15,21,6,5,32,3.368566361237653e-06,2.8316834942407983e-06
1046,Czechia,CZE,Summer,2020,22992879.38,10697858.0,2.1492974930121522,4,4,3,11,12,8,3,23,1.00030968805091e-06,2.149963104763589e-06
1047,Dominican Republic,DOM,Summer,2020,7167919.159,10999664.0,0.6516489193669915,0,3,2,5,0,6,2,8,1.1160840158130472e-06,7.272949428273446e-07
1048,Ecuador,ECU,Summer,2020,5645199.289999999,17588595.0,0.3209579440540873,2,1,0,3,6,2,0,8,1.4171333178921309e-06,4.548401961612056e-07
1049,"Egypt, Arab Rep.",EGY,Summer,2020,3398801.432,107465134.0,0.03162701525129071,1,1,4,6,3,2,4,9,2.6479922937728127e-06,8.374809266045302e-08
1050,Spain,ESP,Summer,2020,26959675.439999998,47365655.0,0.5691819407965539,3,8,6,17,9,16,6,31,1.1498654747900038e-06,6.544826625959252e-07
1051,Estonia,EST,Summer,2020,23595243.68,1329522.0,17.747163025508417,1,0,1,2,3,0,1,4,1.6952569145918648e-07,3.0086000833382222e-06
1052,Ethiopia,ETH,Summer,2020,918652.5941,117190911.0,0.007838940633373863,1,1,2,4,3,2,2,7,7.619855476332563e-06,5.973159471385968e-08
1053,Finland,FIN,Summer,2020,49170752.15,5529543.0,8.892371783707985,0,0,2,2,0,0,2,2,4.067458626418429e-08,3.6169354320962874e-07
1054,France,FRA,Summer,2020,39055282.93,67571107.0,0.5779879102765032,10,12,11,33,30,24,11,65,1.6643074924460674e-06,9.619496096164296e-07
1055,United Kingdom,GBR,Summer,2020,40318557.57,67081000.0,0.601042882038133,22,20,22,64,66,40,22,128,3.1747167486775743e-06,1.9081409042799005e-06
1056,Georgia,GEO,Summer,2020,4255742.993,3722716.0,1.143182287609369,2,5,1,8,6,10,1,17,3.994602124226537e-06,4.566558394462538e-06
1057,Ghana,GHA,Summer,2020,2176579.4590000003,32180401.0,0.06763680350036658,0,0,1,1,0,0,1,1,4.594364776645629e-07,3.1074814760698604e-08
1058,"Hong Kong SAR, China",HKG,Summer,2020,46107765.28,7481000.0,6.163315770618901,1,2,3,6,3,4,3,10,2.168832069668244e-07,1.336719689881032e-06
1059,Hungary,HUN,Summer,2020,16120989.05,9750149.0,1.6534095068701002,6,7,7,20,18,14,7,39,2.4192064071900104e-06,3.999938872729022e-06
1060,India,IND,Summer,2020,1910421.473,1396387127.0,0.0013681173623423127,1,2,4,7,3,4,4,11,5.7578917298947255e-06,7.877471646156188e-09
1061,Ireland,IRL,Summer,2020,85420190.86,4985382.0,17.13413151890868,2,0,2,4,6,0,2,8,9.365467250139553e-08,1.6046914759992314e-06
1062,Israel,ISR,Summer,2020,44846791.599999994,9215100.0,4.866663584768477,2,0,2,4,6,0,2,8,1.7838511328422435e-07,8.681403348851342e-07
1063,Italy,ITA,Summer,2020,31911035.790000003,59438851.0,0.536871679938766,10,10,20,40,30,20,20,70,2.193598492404185e-06,1.1776809077281792e-06
1064,Jamaica,JAM,Summer,2020,4897265.897,2820436.0,1.7363506553596677,4,1,4,9,12,2,4,18,3.675520255297259e-06,6.381992004073129e-06
1065,Jordan,JOR,Summer,2020,4042769.35,10928721.0,0.3699215443417395,0,1,1,2,0,2,1,3,7.420655843252596e-07,2.7450604695645535e-07
1066,Japan,JPN,Summer,2020,39918167.56,126261000.0,0.31615595916395406,27,14,17,58,81,28,17,126,3.156457515506255e-06,9.979328533751514e-07
1067,Kazakhstan,KAZ,Summer,2020,9121637.138,18755666.0,0.4863403484579007,0,0,8,8,0,0,8,8,8.770355451515002e-07,4.2653777263894546e-07
1068,Kenya,KEN,Summer,2020,1936424.589,51985780.0,0.03724912060567332,4,4,2,10,12,8,2,22,1.1361144722584392e-05,4.23192649990055e-07
1069,Kyrgyz Republic,KGZ,Summer,2020,1182521.7,6579900.0,0.17971727533853096,0,2,1,3,0,4,1,5,4.228252217274321e-06,7.598899679326434e-07
1070,"Korea, Rep.",KOR,Summer,2020,31721298.91,51836239.0,0.6119521694079696,6,4,10,20,18,8,10,36,1.1348841704792598e-06,6.944948301515471e-07
1071,Lithuania,LTU,Summer,2020,20339521.27,2794885.0,7.277409006095063,0,1,0,1,0,2,0,2,9.833073126209327e-08,7.155929492626709e-07
1072,Morocco,MAR,Summer,2020,3258121.338,36688772.0,0.0888043169719608,1,0,0,1,3,0,0,3,9.207760205276922e-07,8.176888558712186e-08
1073,Moldova,MDA,Summer,2020,4500624.464000001,2635130.0,1.7079326120532956,0,0,1,1,0,0,1,1,2.2219138877257808e-07,3.7948791900209856e-07
1074,Mexico,MEX,Summer,2020,8655000.682,125998302.0,0.06869140730166348,0,0,4,4,0,0,4,4,4.6216056439127616e-07,3.1746459567367824e-08
1075,North Macedonia,MKD,Summer,2020,5965450.232,2072531.0,2.8783406530469264,0,1,0,1,0,2,0,2,3.352638815544141e-07,9.650036597763797e-07
1076,Namibia,NAM,Summer,2020,4251172.766,2489098.0,1.7079169908135396,0,1,0,1,0,2,0,2,4.7045841467455434e-07,8.035039198938732e-07
1077,Norway,NOR,Summer,2020,67329677.79,5379475.0,12.516031358078624,4,2,2,8,12,4,2,18,2.67341246695724e-07,3.3460514269515147e-06
1078,New Zealand,NZL,Summer,2020,41596505.5,5090200.0,8.17188037798122,7,6,7,20,21,12,7,40,9.61619239866195e-07,7.858237397351773e-06
1079,Poland,POL,Summer,2020,15816989.4,37899070.0,0.41734505358574764,4,5,5,14,12,10,5,27,1.7070252319951609e-06,7.124185369192436e-07
1080,Qatar,QAT,Summer,2020,52315660.08,2760385.0,18.952305595052863,2,0,1,3,6,0,1,7,1.338031478393993e-07,2.535878147432333e-06
1081,Romania,ROU,Summer,2020,13047432.059999999,19265250.0,0.6772521540078639,1,3,0,4,3,6,0,9,6.897909074071087e-07,4.671623778565033e-07
1082,San Marino,SMR,Summer,2020,45320208.72,34007.0,1332.6729414532301,0,1,2,3,0,2,2,4,8.82608468269208e-08,0.00011762284235598553
1083,Serbia,SRB,Summer,2020,7733802.869,6899126.0,1.1209829866855598,3,1,5,9,9,2,5,16,2.068839905932182e-06,2.3191343367261304e-06
1084,Slovak Republic,SVK,Summer,2020,19545742.82,5458827.0,3.580575610840937,1,2,1,4,3,4,1,8,4.0929628889898595e-07,1.4655163096394152e-06
1085,Sweden,SWE,Summer,2020,52837903.980000004,10353442.0,5.103414302219494,3,6,0,9,9,12,0,21,3.974419577269537e-07,2.028310971365851e-06
1086,Syrian Arab Republic,SYR,Summer,2020,533385.2317,20772595.0,0.025677351900424573,0,0,1,1,0,0,1,1,1.8748175625575724e-06,4.814035030288705e-08
1087,Thailand,THA,Summer,2020,6990935.503,71475664.0,0.09780861221520096,1,0,1,2,3,0,1,4,5.721694898034021e-07,5.5963103749550333e-08
1088,Turkmenistan,TKM,Summer,2020,0.0,6250438.0,0.0,0,1,0,1,0,2,0,2,0.0,3.1997757597147593e-07
1089,Tunisia,TUN,Summer,2020,3497681.41,12161723.0,0.28759752298255764,1,1,0,2,3,2,0,5,1.4295184191747184e-06,4.1112595641259054e-07
1090,Turkiye,TUR,Summer,2020,8561070.948,84135428.0,0.10175346048040548,2,2,9,13,6,4,9,19,2.2193485038736534e-06,2.258263902811548e-07
1091,Uganda,UGA,Summer,2020,846767.2013,44404611.0,0.01906935298453577,2,1,1,4,6,2,1,9,1.0628659194856323e-05,2.02681653939047e-07
1092,Ukraine,UKR,Summer,2020,3751740.7229999998,44132049.0,0.08501170482702944,1,6,12,19,3,12,12,27,7.196659362539857e-06,6.118002814689161e-07
1093,United States,USA,Summer,2020,63530633.48,331501080.0,0.1916453288176316,39,41,33,113,117,82,33,232,3.651781625521421e-06,6.998468903932379e-07
1094,Uzbekistan,UZB,Summer,2020,1749655.8150000002,34232050.0,0.05111162828402039,3,0,2,5,9,0,2,11,6.286950785232008e-06,3.213362915747085e-07
1095,"Venezuela, RB",VEN,Summer,2020,0.0,28490453.0,0.0,1,3,0,4,3,6,0,9,0.0,3.1589529306536473e-07
