,Country_Name,Country_Code,Season,Year,GDP,Population,GDP_per_capita,Gold,Silver,Bronze,Total_Medals,Gold_Score,Silver_Score,Bronze_Score,Total_Score,Medal_score_per_GDP,Medal_score_per_capita
0,Argentina,ARG,Summer,1960,0.0,20349744.0,0.0,0,1,1,2,0,2,1,3,0.0,1.474220019671992e-07
13,Ethiopia,ETH,Summer,1960,0.0,21739710.0,0.0,1,0,0,1,3,0,0,3,0.0,1.3799632101808165e-07
24,Hungary,HUN,Summer,1960,0.0,9983967.0,0.0,6,8,7,21,18,16,7,41,0.0,4.106584086265509e-06
40,Poland,POL,Summer,1960,0.0,29637450.0,0.0,4,6,11,21,12,12,11,35,0.0,1.1809383060958348e-06
41,Poland,POL,Summer,1960,0.0,29637450.0,0.0,4,6,11,21,12,12,11,35,0.0,1.1809383060958348e-06
42,Poland,POL,Winter,1960,0.0,29637450.0,0.0,0,1,1,2,0,2,1,3,0.0,1.0122328337964299e-07
43,Poland,POL,Winter,1960,0.0,29637450.0,0.0,0,1,1,2,0,2,1,3,0.0,1.0122328337964299e-07
44,Romania,ROU,Summer,1960,0.0,18406905.0,0.0,3,1,6,10,9,2,6,17,0.0,9.235664550884572e-07
65,Cuba,CUB,Summer,1964,0.0,7902286.0,0.0,0,1,0,1,0,2,0,2,0.0,2.530913206634131e-07
66,Ethiopia,ETH,Summer,1964,0.0,24073696.0,0.0,1,0,0,1,3,0,0,3,0.0,1.24617341682806e-07
80,Hungary,HUN,Summer,1964,0.0,10119835.0,0.0,10,7,5,22,30,14,5,49,0.0,4.84197617846536e-06
94,Poland,POL,Summer,1964,0.0,31139450.0,0.0,7,6,10,23,21,12,10,43,0.0,1.3808850188426579e-06
95,"Korea, Dem. People's Rep.",PRK,Winter,1964,0.0,12787523.0,0.0,0,1,0,1,0,2,0,2,0.0,1.564024557375185e-07
96,Romania,ROU,Summer,1964,0.0,18919126.0,0.0,2,4,6,12,6,8,6,20,0.0,1.0571312860858373e-06
102,Tunisia,TUN,Summer,1964,0.0,4389417.0,0.0,0,1,1,2,0,2,1,3,0.0,6.834620634129772e-07
121,Cuba,CUB,Summer,1968,0.0,8550286.0,0.0,0,4,0,4,0,8,0,8,0.0,9.356412171475902e-07
122,Ethiopia,ETH,Summer,1968,0.0,26778653.0,0.0,1,1,0,2,3,2,0,5,0.0,1.8671588895826836e-07
132,Hungary,HUN,Summer,1968,0.0,10255815.0,0.0,10,10,12,32,30,20,12,62,0.0,6.045350857050366e-06
149,Poland,POL,Summer,1968,0.0,32294655.0,0.0,5,2,11,18,15,4,11,30,0.0,9.289462915767331e-07
150,Romania,ROU,Summer,1968,0.0,19799831.0,0.0,4,6,5,15,12,12,5,29,0.0,1.4646589660285483e-06
151,Romania,ROU,Summer,1968,0.0,19799831.0,0.0,4,6,5,15,12,12,5,29,0.0,1.4646589660285483e-06
152,Romania,ROU,Winter,1968,0.0,19799831.0,0.0,0,0,1,1,0,0,1,1,0.0,5.050548158719132e-08
153,Romania,ROU,Winter,1968,0.0,19799831.0,0.0,0,0,1,1,0,0,1,1,0.0,5.050548158719132e-08
184,Ethiopia,ETH,Summer,1972,0.0,29891328.0,0.0,0,0,2,2,0,0,2,2,0.0,6.690903796579396e-08
195,Hungary,HUN,Summer,1972,0.0,10398489.0,0.0,6,13,16,35,18,26,16,60,0.0,5.770069093692363e-06
208,Lebanon,LBN,Summer,1972,0.0,2505965.0,0.0,0,1,0,1,0,2,0,2,0.0,7.980957435558757e-07
216,Poland,POL,Summer,1972,0.0,33055650.0,0.0,7,5,9,21,21,10,9,40,0.0,1.2100805762403705e-06
217,Poland,POL,Summer,1972,0.0,33055650.0,0.0,7,5,9,21,21,10,9,40,0.0,1.2100805762403705e-06
218,Poland,POL,Winter,1972,0.0,33055650.0,0.0,1,0,0,1,3,0,0,3,0.0,9.075604321802778e-08
219,Poland,POL,Winter,1972,0.0,33055650.0,0.0,1,0,0,1,3,0,0,3,0.0,9.075604321802778e-08
220,"Korea, Dem. People's Rep.",PRK,Summer,1972,0.0,15768363.0,0.0,1,1,3,5,3,2,3,8,0.0,5.073449919944131e-07
221,Romania,ROU,Summer,1972,0.0,20657957.0,0.0,3,6,7,16,9,12,7,28,0.0,1.3554099275160655e-06
258,Hungary,HUN,Summer,1976,0.0,10598677.0,0.0,4,5,13,22,12,10,13,35,0.0,3.302298956747149e-06
274,Poland,POL,Summer,1976,0.0,34356300.0,0.0,7,6,13,26,21,12,13,46,0.0,1.3389101853226338e-06
275,"Korea, Dem. People's Rep.",PRK,Summer,1976,0.0,16987170.0,0.0,1,1,0,2,3,2,0,5,0.0,2.943397870275037e-07
276,Romania,ROU,Summer,1976,0.0,21551634.0,0.0,4,9,14,27,12,18,14,44,0.0,2.0416085388235527e-06
298,Ethiopia,ETH,Summer,1980,0.0,34945469.0,0.0,2,0,2,4,6,0,2,8,0.0,2.2892810509997734e-07
312,Hungary,HUN,Summer,1980,0.0,10711122.0,0.0,7,10,15,32,21,20,15,56,0.0,5.228210452649125e-06
313,Hungary,HUN,Summer,1980,0.0,10711122.0,0.0,7,10,15,32,21,20,15,56,0.0,5.228210452649125e-06
314,Hungary,HUN,Winter,1980,0.0,10711122.0,0.0,0,1,0,1,0,2,0,2,0.0,1.8672180188032588e-07
315,Hungary,HUN,Winter,1980,0.0,10711122.0,0.0,0,1,0,1,0,2,0,2,0.0,1.8672180188032588e-07
324,Lebanon,LBN,Summer,1980,0.0,2963702.0,0.0,0,0,1,1,0,0,1,1,0.0,3.374158400540945e-07
328,Poland,POL,Summer,1980,0.0,35574150.0,0.0,3,14,15,32,9,28,15,52,0.0,1.4617355579824113e-06
329,"Korea, Dem. People's Rep.",PRK,Summer,1980,0.0,17973650.0,0.0,0,3,2,5,0,6,2,8,0.0,4.4509601555610575e-07
330,Romania,ROU,Summer,1980,0.0,22207282.0,0.0,6,6,13,25,18,12,13,43,0.0,1.9363017950598368e-06
391,Romania,ROU,Summer,1984,0.0,22640547.0,0.0,20,16,17,53,60,32,17,109,0.0,4.814371313555278e-06
416,Channel Islands,CHI,Summer,1988,0.0,137765.0,0.0,0,1,0,1,0,2,0,2,0.0,1.4517475411026022e-05
430,Hungary,HUN,Summer,1988,0.0,10596487.0,0.0,11,6,6,23,33,12,6,51,0.0,4.812915827670057e-06
452,Poland,POL,Summer,1988,0.0,37824487.0,0.0,2,5,9,16,6,10,9,25,0.0,6.609474967895797e-07
488,Estonia,EST,Summer,1992,0.0,1533091.0,0.0,1,0,1,2,3,0,1,4,0.0,2.6091080046781307e-06
502,Israel,ISR,Summer,1992,0.0,5123000.0,0.0,0,1,1,2,0,2,1,3,0.0,5.855943782939684e-07
517,Lithuania,LTU,Summer,1992,0.0,3700114.0,0.0,1,0,1,2,3,0,1,4,0.0,1.081047773122666e-06
533,"Korea, Dem. People's Rep.",PRK,Summer,1992,0.0,21439991.0,0.0,4,0,5,9,12,0,5,17,0.0,7.929107806062045e-07
534,"Korea, Dem. People's Rep.",PRK,Summer,1992,0.0,21439991.0,0.0,4,0,5,9,12,0,5,17,0.0,7.929107806062045e-07
535,"Korea, Dem. People's Rep.",PRK,Winter,1992,0.0,21439991.0,0.0,0,0,1,1,0,0,1,1,0.0,4.664181062389439e-08
536,"Korea, Dem. People's Rep.",PRK,Winter,1992,0.0,21439991.0,0.0,0,0,1,1,0,0,1,1,0.0,4.664181062389439e-08
608,"Korea, Dem. People's Rep.",PRK,Summer,1996,0.0,22614347.0,0.0,2,1,2,5,6,2,2,10,0.0,4.421971591751024e-07
684,"Korea, Dem. People's Rep.",PRK,Summer,2000,0.0,23367059.0,0.0,0,1,3,4,0,2,3,5,0.0,2.1397643580221199e-07
754,"Korea, Dem. People's Rep.",PRK,Summer,2004,0.0,23948930.0,0.0,0,4,1,5,0,8,1,9,0.0,3.7579967038193355e-07
796,Channel Islands,CHI,Summer,2008,0.0,154475.0,0.0,0,1,0,1,0,2,0,2,0.0,1.2947078815342289e-05
832,"Korea, Dem. People's Rep.",PRK,Summer,2008,0.0,24469047.0,0.0,2,2,2,6,6,4,2,12,0.0,4.904155033091399e-07
911,"Korea, Dem. People's Rep.",PRK,Summer,2012,0.0,24887770.0,0.0,4,0,3,7,12,0,3,15,0.0,6.027056662770509e-07
991,"Korea, Dem. People's Rep.",PRK,Summer,2016,0.0,25389611.0,0.0,2,3,2,7,6,6,2,14,0.0,5.514066363600451e-07
1007,"Venezuela, RB",VEN,Summer,2016,0.0,30741464.0,0.0,0,2,1,3,0,4,1,5,0.0,1.626467757033302e-07
1088,Turkmenistan,TKM,Summer,2020,0.0,6250438.0,0.0,0,1,0,1,0,2,0,2,0.0,3.1997757597147593e-07
1095,"Venezuela, RB",VEN,Summer,2020,0.0,28490453.0,0.0,1,3,0,4,3,6,0,9,0.0,3.1589529306536473e-07
