Country_Name,Country_Code,Season,Year,GDP,Population,GDP_per_capita,Gold,Silver,Bronze,Total_Medals,Gold_Score,Silver_Score,Bronze_Score,Total_Score,Medal_score_per_GDP,Medal_score_per_capita,cumulative_medal_count
Australia,AUS,Summer,1960,1810510.249,10276477.0,0.1761800516850278,8,8,6,22,24,16,6,46,2.540720221020964e-05,4.476242198566688e-06,22
Austria,AUT,Summer,1960,935460.4269,7047539.0,0.13273575738992,1,1,0,2,3,2,0,5,5.344961535753448e-06,7.094675176682244e-07,2
Austria,AUT,Summer,1960,935460.4269,7047539.0,0.13273575738992,1,1,0,2,3,2,0,5,5.344961535753448e-06,7.094675176682244e-07,4
Austria,AUT,Winter,1960,935460.4269,7047539.0,0.13273575738992,1,2,3,6,3,4,3,10,1.0689923071506896e-05,1.4189350353364487e-06,10
Austria,AUT,Winter,1960,935460.4269,7047539.0,0.13273575738992,1,2,3,6,3,4,3,10,1.0689923071506896e-05,1.4189350353364487e-06,16
Belgium,BEL,Summer,1960,1273691.659,9153489.0,0.1391482153963368,0,2,2,4,0,4,2,6,4.710716253501037e-06,6.554877599131873e-07,4
Brazil,BRA,Summer,1960,232998.7625,73092515.0,0.0031877239755671,0,0,2,2,0,0,2,2,8.583736576712505e-06,2.7362582885538963e-08,2
Canada,CAN,Summer,1960,2259250.5110000004,17909356.0,0.1261491764974687,0,1,0,1,0,2,0,2,8.85249329484383e-07,1.1167347390939129e-07,1
Canada,CAN,Summer,1960,2259250.5110000004,17909356.0,0.1261491764974687,0,1,0,1,0,2,0,2,8.85249329484383e-07,1.1167347390939129e-07,2
Canada,CAN,Winter,1960,2259250.5110000004,17909356.0,0.1261491764974687,2,1,1,4,6,2,1,9,3.983621982679723e-06,5.025306325922607e-07,6
Canada,CAN,Winter,1960,2259250.5110000004,17909356.0,0.1261491764974687,2,1,1,4,6,2,1,9,3.983621982679723e-06,5.025306325922607e-07,10
Spain,ESP,Summer,1960,396392.2533,30455000.0,0.0130156707699885,0,0,1,1,0,0,1,1,2.5227536403017794e-06,3.283533081595797e-08,1
Finland,FIN,Summer,1960,1179353.011,4429634.0,0.2662416377967118,1,1,3,5,3,2,3,8,6.7833803156330775e-06,1.8060182850321268e-06,5
Finland,FIN,Summer,1960,1179353.011,4429634.0,0.2662416377967118,1,1,3,5,3,2,3,8,6.7833803156330775e-06,1.8060182850321268e-06,10
Finland,FIN,Winter,1960,1179353.011,4429634.0,0.2662416377967118,2,3,3,8,6,6,3,15,1.271883809181202e-05,3.386284284435238e-06,18
Finland,FIN,Winter,1960,1179353.011,4429634.0,0.2662416377967118,2,3,3,8,6,6,3,15,1.271883809181202e-05,3.386284284435238e-06,26
France,FRA,Summer,1960,1333881.573,46649927.0,0.0285934332330252,0,2,3,5,0,4,3,7,5.247842193558814e-06,1.500538253789765e-07,5
France,FRA,Summer,1960,1333881.573,46649927.0,0.0285934332330252,0,2,3,5,0,4,3,7,5.247842193558814e-06,1.500538253789765e-07,10
France,FRA,Winter,1960,1333881.573,46649927.0,0.0285934332330252,1,0,2,3,3,0,2,5,3.748458709684867e-06,1.0718130384212607e-07,13
France,FRA,Winter,1960,1333881.573,46649927.0,0.0285934332330252,1,0,2,3,3,0,2,5,3.748458709684867e-06,1.0718130384212607e-07,16
United Kingdom,GBR,Summer,1960,1397594.8029999998,52400000.0,0.0266716565458015,2,6,12,20,6,12,12,30,2.1465449023997267e-05,5.725190839694656e-07,20
Ghana,GHA,Summer,1960,176095.64839999998,6911510.0,0.0254786071929288,0,1,0,1,0,2,0,2,1.1357464072348991e-05,2.893723658071825e-07,1
India,IND,Summer,1960,83035.10182,445954579.0,0.0001861963207244,0,1,0,1,0,2,0,2,2.408619916352383e-05,4.484761664483324e-09,1
Iraq,IRQ,Summer,1960,237713.2079,7084678.0,0.033553142132924,0,0,1,1,0,0,1,1,4.206749842948042e-06,1.4114967539809148e-07,1
Italy,ITA,Summer,1960,804492.6233,50199700.0,0.0160258452401109,13,10,13,36,39,20,13,72,8.949740235610685e-05,1.4342715195509135e-06,36
Italy,ITA,Summer,1960,804492.6233,50199700.0,0.0160258452401109,13,10,13,36,39,20,13,72,8.949740235610685e-05,1.4342715195509135e-06,72
Italy,ITA,Winter,1960,804492.6233,50199700.0,0.0160258452401109,0,0,1,1,0,0,1,1,1.243019477168151e-06,1.9920437771540467e-08,73
Italy,ITA,Winter,1960,804492.6233,50199700.0,0.0160258452401109,0,0,1,1,0,0,1,1,1.243019477168151e-06,1.9920437771540467e-08,74
Japan,JPN,Summer,1960,475319.0756,93216000.0,0.0050991146970477,4,7,7,18,12,14,7,33,6.942704741724024e-05,3.540164778578785e-07,18
Morocco,MAR,Summer,1960,172598.98380000002,11769774.0,0.0146645962615764,0,1,0,1,0,2,0,2,1.1587553738540607e-05,1.6992679723501913e-07,1
Mexico,MEX,Summer,1960,359545.05970000004,36268055.0,0.0099135467755301,0,0,1,1,0,0,1,1,2.781292561311752e-06,2.7572473902998107e-08,1
Norway,NOR,Summer,1960,1441755.66,3581239.0,0.4025857140503608,1,0,0,1,3,0,0,3,2.0807964090114964e-06,8.376989081153198e-07,1
Norway,NOR,Summer,1960,1441755.66,3581239.0,0.4025857140503608,1,0,0,1,3,0,0,3,2.0807964090114964e-06,8.376989081153198e-07,2
Norway,NOR,Winter,1960,1441755.66,3581239.0,0.4025857140503608,3,3,0,6,9,6,0,15,1.040398204505748e-05,4.188494540576599e-06,8
Norway,NOR,Winter,1960,1441755.66,3581239.0,0.4025857140503608,3,3,0,6,9,6,0,15,1.040398204505748e-05,4.188494540576599e-06,14
New Zealand,NZL,Summer,1960,2312949.992,2371800.0,0.9751876178429882,2,0,1,3,6,0,1,7,3.026438108999981e-06,2.9513449700649296e-06,3
Pakistan,PAK,Summer,1960,81586.9473,45954226.0,0.0017753959624953,1,0,1,2,3,0,1,4,4.902745025244988e-05,8.70431372296424e-08,2
Singapore,SGP,Summer,1960,428058.98,1646400.0,0.2599969509232264,0,1,0,1,0,2,0,2,4.672253342284748e-06,1.2147716229348882e-06,1
Sweden,SWE,Summer,1960,2114002.973,7484656.0,0.2824449076884763,1,2,3,6,3,4,3,10,4.730362316288e-06,1.3360667477570111e-06,6
Sweden,SWE,Summer,1960,2114002.973,7484656.0,0.2824449076884763,1,2,3,6,3,4,3,10,4.730362316288e-06,1.3360667477570111e-06,12
Sweden,SWE,Winter,1960,2114002.973,7484656.0,0.2824449076884763,3,2,2,7,9,4,2,15,7.095543474432e-06,2.004100121635517e-06,19
Sweden,SWE,Winter,1960,2114002.973,7484656.0,0.2824449076884763,3,2,2,7,9,4,2,15,7.095543474432e-06,2.004100121635517e-06,26
Turkiye,TUR,Summer,1960,508290.6132,27510980.0,0.0184759180952477,7,2,0,9,21,4,0,25,4.918446131162982e-05,9.087280787525562e-07,9
United States,USA,Summer,1960,3007123.4450000003,180671000.0,0.0166441954990009,34,21,16,71,102,42,16,160,5.320699430082758e-05,8.855876150572034e-07,71
United States,USA,Summer,1960,3007123.4450000003,180671000.0,0.0166441954990009,34,21,16,71,102,42,16,160,5.320699430082758e-05,8.855876150572034e-07,142
United States,USA,Winter,1960,3007123.4450000003,180671000.0,0.0166441954990009,3,4,3,10,9,8,3,20,6.650874287603447e-06,1.1069845188215045e-07,152
United States,USA,Winter,1960,3007123.4450000003,180671000.0,0.0166441954990009,3,4,3,10,9,8,3,20,6.650874287603447e-06,1.1069845188215045e-07,162
"Venezuela, RB",VEN,Summer,1960,953677.9442,8156937.0,0.1169161836360879,0,0,1,1,0,0,1,1,1.048572011213762e-06,1.2259503781873026e-07,1
Argentina,ARG,Summer,1964,1179504.098,21708487.0,0.0543337772918029,0,1,0,1,0,2,0,2,1.6956278519008588e-06,9.212986607495953e-08,1
Australia,AUS,Summer,1964,2131277.657,11167000.0,0.1908549885376556,6,2,10,18,18,4,10,32,1.5014467915477236e-05,2.8655861019074057e-06,18
Austria,AUT,Winter,1964,1269412.583,7223801.0,0.1757264053923966,4,5,3,12,12,10,3,25,1.9694148565092643e-05,3.4607819346075563e-06,12
Belgium,BEL,Summer,1964,1701846.276,9378113.0,0.1814700117177091,2,0,1,3,6,0,1,7,4.113179961501999e-06,7.46418815810814e-07,3
Brazil,BRA,Summer,1964,254838.581,82262794.0,0.0030978595378124,0,0,1,1,0,0,1,1,3.924052614309605e-06,1.2156163818116853e-08,1
Canada,CAN,Summer,1964,2555111.146,19325000.0,0.1322179118240621,1,2,1,4,3,4,1,8,3.1309792579958475e-06,4.139715394566624e-07,4
Canada,CAN,Summer,1964,2555111.146,19325000.0,0.1322179118240621,1,2,1,4,3,4,1,8,3.1309792579958475e-06,4.139715394566624e-07,8
Canada,CAN,Winter,1964,2555111.146,19325000.0,0.1322179118240621,1,1,1,3,3,2,1,6,2.348234443496885e-06,3.104786545924968e-07,11
Canada,CAN,Winter,1964,2555111.146,19325000.0,0.1322179118240621,1,1,1,3,3,2,1,6,2.348234443496885e-06,3.104786545924968e-07,14
Finland,FIN,Summer,1964,1707503.938,4548543.0,0.3753957999297797,3,0,2,5,9,0,2,11,6.442152053180213e-06,2.418356823272859e-06,5
Finland,FIN,Summer,1964,1707503.938,4548543.0,0.3753957999297797,3,0,2,5,9,0,2,11,6.442152053180213e-06,2.418356823272859e-06,10
Finland,FIN,Winter,1964,1707503.938,4548543.0,0.3753957999297797,3,4,3,10,9,8,3,20,1.1713003733054931e-05,4.397012405950653e-06,20
Finland,FIN,Winter,1964,1707503.938,4548543.0,0.3753957999297797,3,4,3,10,9,8,3,20,1.1713003733054931e-05,4.397012405950653e-06,30
France,FRA,Summer,1964,1928999.402,48733997.0,0.0395822120233643,1,8,6,15,3,16,6,25,1.296008696222499e-05,5.12988909980029e-07,15
France,FRA,Summer,1964,1928999.402,48733997.0,0.0395822120233643,1,8,6,15,3,16,6,25,1.296008696222499e-05,5.12988909980029e-07,30
France,FRA,Winter,1964,1928999.402,48733997.0,0.0395822120233643,3,4,0,7,9,8,0,17,8.812859134312992e-06,3.488324587864197e-07,37
France,FRA,Winter,1964,1928999.402,48733997.0,0.0395822120233643,3,4,0,7,9,8,0,17,8.812859134312992e-06,3.488324587864197e-07,44
United Kingdom,GBR,Summer,1964,1748288.118,54000000.0,0.0323757058888888,4,12,2,18,12,24,2,38,2.1735547824617773e-05,7.037037037037037e-07,18
United Kingdom,GBR,Summer,1964,1748288.118,54000000.0,0.0323757058888888,4,12,2,18,12,24,2,38,2.1735547824617773e-05,7.037037037037037e-07,36
United Kingdom,GBR,Winter,1964,1748288.118,54000000.0,0.0323757058888888,1,0,0,1,3,0,0,3,1.7159643019435085e-06,5.555555555555556e-08,37
United Kingdom,GBR,Winter,1964,1748288.118,54000000.0,0.0323757058888888,1,0,0,1,3,0,0,3,1.7159643019435085e-06,5.555555555555556e-08,38
Ghana,GHA,Summer,1964,226576.967,7640196.0,0.0296559102672235,0,0,1,1,0,0,1,1,4.413511281577001e-06,1.308866945298262e-07,1
India,IND,Summer,1964,115487.6084,489059309.0,0.000236142337493,1,0,0,1,3,0,0,3,2.5976812937447583e-05,6.1342253276687965e-09,1
Ireland,IRL,Summer,1964,965135.4227,2866550.0,0.3366888499066822,0,0,1,1,0,0,1,1,1.0361240262039755e-06,3.488514067432977e-07,1
Italy,ITA,Summer,1964,1222544.54,51675350.0,0.0236581762871465,10,10,7,27,30,20,7,57,4.66240681914133e-05,1.1030404244963992e-06,27
Italy,ITA,Summer,1964,1222544.54,51675350.0,0.0236581762871465,10,10,7,27,30,20,7,57,4.66240681914133e-05,1.1030404244963992e-06,54
Italy,ITA,Winter,1964,1222544.54,51675350.0,0.0236581762871465,0,1,3,4,0,2,3,5,4.089830543106429e-06,9.675793197336837e-08,58
Italy,ITA,Winter,1964,1222544.54,51675350.0,0.0236581762871465,0,1,3,4,0,2,3,5,4.089830543106429e-06,9.675793197336837e-08,62
Japan,JPN,Summer,1964,843616.8785,96903000.0,0.0087057870086581,16,5,8,29,48,10,8,66,7.823456557359526e-05,6.810934645986192e-07,29
Kenya,KEN,Summer,1964,110392.0208,9047387.0,0.0122015362888754,0,0,1,1,0,0,1,1,9.058625729949496e-06,1.1052915057131967e-07,1
"Korea, Rep.",KOR,Summer,1964,123606.8369,27984155.0,0.0044170294547039,0,2,1,3,0,4,1,5,4.045083690674072e-05,1.7867253808449817e-07,3
Mexico,MEX,Summer,1964,485800.05,41333878.0,0.0117530721409687,0,0,1,1,0,0,1,1,2.058460059853843e-06,2.419322958276501e-08,1
Norway,NOR,Winter,1964,1937884.614,3694339.0,0.5245551677850896,3,6,6,15,9,12,6,27,1.3932718080809326e-05,7.3084792705812865e-06,15
New Zealand,NZL,Summer,1964,2813546.9760000003,2585400.0,1.088244362961244,3,0,2,5,9,0,2,11,3.90965570997454e-06,4.254660787499033e-06,5
Pakistan,PAK,Summer,1964,102961.2072,50552592.0,0.0020367146990207,0,1,0,1,0,2,0,2,1.9424791670469068e-05,3.956275872066065e-08,1
Sweden,SWE,Summer,1964,2941048.899,7661354.0,0.3838810866851995,2,2,4,8,6,4,4,14,4.760206470813936e-06,1.827353232861972e-06,8
Sweden,SWE,Summer,1964,2941048.899,7661354.0,0.3838810866851995,2,2,4,8,6,4,4,14,4.760206470813936e-06,1.827353232861972e-06,16
Sweden,SWE,Winter,1964,2941048.899,7661354.0,0.3838810866851995,3,3,1,7,9,6,1,16,5.440235966644498e-06,2.0884036946993966e-06,23
Sweden,SWE,Winter,1964,2941048.899,7661354.0,0.3838810866851995,3,3,1,7,9,6,1,16,5.440235966644498e-06,2.0884036946993966e-06,30
Trinidad and Tobago,TTO,Summer,1964,779389.2566,913399.0,0.8532845520960719,0,1,2,3,0,2,2,4,5.132223681719146e-06,4.379247185512574e-06,3
Turkiye,TUR,Summer,1964,365133.8692,30612821.0,0.0119274819266084,2,3,1,6,6,6,1,13,3.56033802848328e-05,4.246586748735114e-07,6
United States,USA,Summer,1964,3573941.185,191889000.0,0.0186250446091229,36,26,28,90,108,52,28,188,5.260299212226684e-05,9.79733074850565e-07,90
United States,USA,Summer,1964,3573941.185,191889000.0,0.0186250446091229,36,26,28,90,108,52,28,188,5.260299212226684e-05,9.79733074850565e-07,180
United States,USA,Winter,1964,3573941.185,191889000.0,0.0186250446091229,1,2,4,7,3,4,4,11,3.077834645451783e-06,5.7324807571043686e-08,187
United States,USA,Winter,1964,3573941.185,191889000.0,0.0186250446091229,1,2,4,7,3,4,4,11,3.077834645451783e-06,5.7324807571043686e-08,194
Argentina,ARG,Summer,1968,1143810.428,23112971.0,0.0494878147859052,0,0,2,2,0,0,2,2,1.7485414986966702e-06,8.653149783297008e-08,2
Australia,AUS,Summer,1968,2723999.484,12009000.0,0.226829834624032,5,7,5,17,15,14,5,34,1.2481647004599798e-05,2.8312099258889166e-06,17
Austria,AUT,Summer,1968,1677673.528,7415403.0,0.2262417198363999,0,2,2,4,0,4,2,6,3.576381161090837e-06,8.09126624675692e-07,4
Austria,AUT,Summer,1968,1677673.528,7415403.0,0.2262417198363999,0,2,2,4,0,4,2,6,3.576381161090837e-06,8.09126624675692e-07,8
Austria,AUT,Winter,1968,1677673.528,7415403.0,0.2262417198363999,3,4,4,11,9,8,4,21,1.2517334063817928e-05,2.831943186364922e-06,19
Austria,AUT,Winter,1968,1677673.528,7415403.0,0.2262417198363999,3,4,4,11,9,8,4,21,1.2517334063817928e-05,2.831943186364922e-06,30
Belgium,BEL,Summer,1968,2222361.511,9618756.0,0.2310445873665991,0,1,1,2,0,2,1,3,1.3499153873710157e-06,3.118906436549592e-07,2
Brazil,BRA,Summer,1968,370180.4118,91659246.0,0.0040386587055276,0,1,2,3,0,2,2,4,1.0805542034355692e-05,4.363989640499552e-08,3
Canada,CAN,Summer,1968,3462678.872,20744000.0,0.1669243575009641,1,3,1,5,3,6,1,10,2.887937452376034e-06,4.820671037408407e-07,5
Canada,CAN,Summer,1968,3462678.872,20744000.0,0.1669243575009641,1,3,1,5,3,6,1,10,2.887937452376034e-06,4.820671037408407e-07,10
Canada,CAN,Winter,1968,3462678.872,20744000.0,0.1669243575009641,1,1,1,3,3,2,1,6,1.7327624714256206e-06,2.892402622445045e-07,13
Canada,CAN,Winter,1968,3462678.872,20744000.0,0.1669243575009641,1,1,1,3,3,2,1,6,1.7327624714256206e-06,2.892402622445045e-07,16
Cameroon,CMR,Summer,1968,170745.5914,6127193.0,0.0278668537779044,0,1,0,1,0,2,0,2,1.1713333173649366e-05,3.2641374280196496e-07,1
Finland,FIN,Summer,1968,1907077.272,4626469.0,0.4122101049418033,1,2,1,4,3,4,1,8,4.194900813646737e-06,1.7291805046137778e-06,4
Finland,FIN,Summer,1968,1907077.272,4626469.0,0.4122101049418033,1,2,1,4,3,4,1,8,4.194900813646737e-06,1.7291805046137778e-06,8
Finland,FIN,Winter,1968,1907077.272,4626469.0,0.4122101049418033,1,2,2,5,3,4,2,9,4.71926341535258e-06,1.9453280676905e-06,13
Finland,FIN,Winter,1968,1907077.272,4626469.0,0.4122101049418033,1,2,2,5,3,4,2,9,4.71926341535258e-06,1.9453280676905e-06,18
France,FRA,Summer,1968,2553975.8430000003,50817020.0,0.050258276518379,7,3,5,15,21,6,5,32,1.2529484210943647e-05,6.297102821062707e-07,15
France,FRA,Summer,1968,2553975.8430000003,50817020.0,0.050258276518379,7,3,5,15,21,6,5,32,1.2529484210943647e-05,6.297102821062707e-07,30
France,FRA,Winter,1968,2553975.8430000003,50817020.0,0.050258276518379,4,3,2,9,12,6,2,20,7.83092763183978e-06,3.935689263164192e-07,39
France,FRA,Winter,1968,2553975.8430000003,50817020.0,0.050258276518379,4,3,2,9,12,6,2,20,7.83092763183978e-06,3.935689263164192e-07,48
United Kingdom,GBR,Summer,1968,1951758.596,55211700.0,0.0353504528206883,5,5,3,13,15,10,3,28,1.434603647058819e-05,5.071388854174025e-07,13
India,IND,Summer,1968,99516.83612,533431909.0,0.0001865595860333,0,0,1,1,0,0,1,1,1.0048550968744364e-05,1.874653508963596e-09,1
Italy,ITA,Summer,1968,1651939.377,53235750.0,0.031030639692312,3,4,9,16,9,8,9,26,1.573907636200139e-05,4.883936076790503e-07,16
Italy,ITA,Summer,1968,1651939.377,53235750.0,0.031030639692312,3,4,9,16,9,8,9,26,1.573907636200139e-05,4.883936076790503e-07,32
Italy,ITA,Winter,1968,1651939.377,53235750.0,0.031030639692312,4,0,0,4,12,0,0,12,7.264189090154488e-06,2.2541243431340785e-07,36
Italy,ITA,Winter,1968,1651939.377,53235750.0,0.031030639692312,4,0,0,4,12,0,0,12,7.264189090154488e-06,2.2541243431340785e-07,40
Jamaica,JAM,Summer,1968,598100.6359,1812209.0,0.3300395461561001,0,1,0,1,0,2,0,2,3.3439188657448477e-06,1.1036254648332504e-06,1
Japan,JPN,Summer,1968,1451337.703,101011000.0,0.014368115383473,11,7,7,25,33,14,7,54,3.720705380172984e-05,5.345952421023453e-07,25
Kenya,KEN,Summer,1968,127502.4628,10613877.0,0.0120128076479499,3,4,2,9,9,8,2,19,0.0001490167294243,1.7901093069007678e-06,9
"Korea, Rep.",KOR,Summer,1968,198431.298,30838302.0,0.0064345727595507,0,1,1,2,0,2,1,3,1.5118582755024864e-05,9.728162075849701e-08,2
Mexico,MEX,Summer,1968,622425.0634,47170337.0,0.0131952642907766,3,3,3,9,9,6,3,18,2.8919143939472668e-05,3.815957473443533e-07,9
Norway,NOR,Summer,1968,2662117.492,3816486.0,0.6975310513388494,1,1,0,2,3,2,0,5,1.8782041044490456e-06,1.310105683605285e-06,2
Norway,NOR,Summer,1968,2662117.492,3816486.0,0.6975310513388494,1,1,0,2,3,2,0,5,1.8782041044490456e-06,1.310105683605285e-06,4
Norway,NOR,Winter,1968,2662117.492,3816486.0,0.6975310513388494,6,6,2,14,18,12,2,32,1.2020506268473894e-05,8.384676375073825e-06,18
Norway,NOR,Winter,1968,2662117.492,3816486.0,0.6975310513388494,6,6,2,14,18,12,2,32,1.2020506268473894e-05,8.384676375073825e-06,32
New Zealand,NZL,Summer,1968,1885156.152,2748100.0,0.6859852814671955,1,0,2,3,3,0,2,5,2.6523001793222278e-06,1.8194388850478512e-06,3
Pakistan,PAK,Summer,1968,143287.94629999998,56124743.0,0.00255302632388,1,0,0,1,3,0,0,3,2.0936862293489376e-05,5.3452360574729044e-08,1
Sweden,SWE,Summer,1968,3926409.001,7912273.0,0.4962428623228749,2,1,1,4,6,2,1,9,2.2921707844770703e-06,1.137473391021771e-06,4
Sweden,SWE,Summer,1968,3926409.001,7912273.0,0.4962428623228749,2,1,1,4,6,2,1,9,2.2921707844770703e-06,1.137473391021771e-06,8
Sweden,SWE,Winter,1968,3926409.001,7912273.0,0.4962428623228749,3,2,3,8,9,4,3,16,4.074970283514792e-06,2.022174917372037e-06,16
Sweden,SWE,Winter,1968,3926409.001,7912273.0,0.4962428623228749,3,2,3,8,9,4,3,16,4.074970283514792e-06,2.022174917372037e-06,24
Tunisia,TUN,Summer,1968,253848.674,4785003.0,0.0530508912951569,1,0,1,2,3,0,1,4,1.575741931982674e-05,8.359451394283348e-07,2
Turkiye,TUR,Summer,1968,516466.80630000005,33884075.0,0.0152421692579773,2,0,0,2,6,0,0,6,1.161739714306979e-05,1.770743335918127e-07,2
Uganda,UGA,Summer,1968,107031.3041,9696370.0,0.0110382858843051,0,1,1,2,0,2,1,3,2.8029182912665268e-05,3.093941340934804e-07,2
United States,USA,Summer,1968,4695923.39,200706000.0,0.0233970254501609,45,28,34,107,135,56,34,225,4.791389920864957e-05,1.1210427192012197e-06,107
United States,USA,Summer,1968,4695923.39,200706000.0,0.0233970254501609,45,28,34,107,135,56,34,225,4.791389920864957e-05,1.1210427192012197e-06,214
United States,USA,Winter,1968,4695923.39,200706000.0,0.0233970254501609,1,5,1,7,3,10,1,14,2.9813092840937517e-06,6.975376919474256e-08,221
United States,USA,Winter,1968,4695923.39,200706000.0,0.0233970254501609,1,5,1,7,3,10,1,14,2.9813092840937517e-06,6.975376919474256e-08,228
"Venezuela, RB",VEN,Summer,1968,940201.4199,10672654.0,0.0880944346082989,1,0,0,1,3,0,0,3,3.190805647069838e-06,2.810922194235848e-07,1
Argentina,ARG,Summer,1972,1411176.664,24612794.0,0.0573350861344713,0,1,0,1,0,2,0,2,1.417256996250896e-06,8.125855195472728e-08,1
Australia,AUS,Summer,1972,3949461.643,13177000.0,0.299723885785839,8,7,2,17,24,14,2,40,1.012796264799678e-05,3.0355923199514306e-06,17
Austria,AUT,Summer,1972,2924048.879,7544201.0,0.3875889413603905,0,1,2,3,0,2,2,4,1.367966188502282e-06,5.30208566818408e-07,3
Austria,AUT,Summer,1972,2924048.879,7544201.0,0.3875889413603905,0,1,2,3,0,2,2,4,1.367966188502282e-06,5.30208566818408e-07,6
Austria,AUT,Winter,1972,2924048.879,7544201.0,0.3875889413603905,1,2,2,5,3,4,2,9,3.0779239241301345e-06,1.192969275341418e-06,11
Austria,AUT,Winter,1972,2924048.879,7544201.0,0.3875889413603905,1,2,2,5,3,4,2,9,3.0779239241301345e-06,1.192969275341418e-06,16
Belgium,BEL,Summer,1972,3831631.9,9711115.0,0.3945614792946021,0,2,0,2,0,4,0,4,1.0439416166255428e-06,4.118991485529726e-07,2
Brazil,BRA,Summer,1972,577451.5371999999,101194394.0,0.0057063589629283,0,0,2,2,0,0,2,2,3.4634941136320874e-06,1.9763940678373945e-08,2
Canada,CAN,Summer,1972,5089587.902,22218463.0,0.2290702062514405,0,2,3,5,0,4,3,7,1.375356931599371e-06,3.150532959908163e-07,5
Canada,CAN,Summer,1972,5089587.902,22218463.0,0.2290702062514405,0,2,3,5,0,4,3,7,1.375356931599371e-06,3.150532959908163e-07,10
Canada,CAN,Winter,1972,5089587.902,22218463.0,0.2290702062514405,0,1,0,1,0,2,0,2,3.92959123314106e-07,9.001522742594753e-08,11
Canada,CAN,Winter,1972,5089587.902,22218463.0,0.2290702062514405,0,1,0,1,0,2,0,2,3.92959123314106e-07,9.001522742594753e-08,12
Colombia,COL,Summer,1972,395987.6223,21898055.0,0.0180832326112981,0,1,2,3,0,2,2,4,1.0101325836315164e-05,1.8266462478060266e-07,3
Cuba,CUB,Summer,1972,887217.1977,9169289.0,0.096759650361113,3,1,4,8,9,2,4,15,1.6906795809285065e-05,1.6358956512331546e-06,8
Spain,ESP,Summer,1972,1708808.6290000002,34604469.0,0.0493811544688057,0,0,1,1,0,0,1,1,5.852030373847087e-07,2.889800158470861e-08,1
Spain,ESP,Summer,1972,1708808.6290000002,34604469.0,0.0493811544688057,0,0,1,1,0,0,1,1,5.852030373847087e-07,2.889800158470861e-08,2
Spain,ESP,Winter,1972,1708808.6290000002,34604469.0,0.0493811544688057,1,0,0,1,3,0,0,3,1.7556091121541263e-06,8.669400475412584e-08,3
Spain,ESP,Winter,1972,1708808.6290000002,34604469.0,0.0493811544688057,1,0,0,1,3,0,0,3,1.7556091121541263e-06,8.669400475412584e-08,4
Finland,FIN,Summer,1972,3177645.701,4639657.0,0.6848880641392241,3,1,4,8,9,2,4,15,4.720475915637645e-06,3.2329976116768976e-06,8
Finland,FIN,Summer,1972,3177645.701,4639657.0,0.6848880641392241,3,1,4,8,9,2,4,15,4.720475915637645e-06,3.2329976116768976e-06,16
Finland,FIN,Winter,1972,3177645.701,4639657.0,0.6848880641392241,0,4,1,5,0,8,1,9,2.832285549382587e-06,1.9397985670061385e-06,21
Finland,FIN,Winter,1972,3177645.701,4639657.0,0.6848880641392241,0,4,1,5,0,8,1,9,2.832285549382587e-06,1.9397985670061385e-06,26
France,FRA,Summer,1972,3865925.4,52637888.0,0.073443778747354,2,4,7,13,6,8,7,21,5.432075849161497e-06,3.989521768046621e-07,13
France,FRA,Summer,1972,3865925.4,52637888.0,0.073443778747354,2,4,7,13,6,8,7,21,5.432075849161497e-06,3.989521768046621e-07,26
France,FRA,Winter,1972,3865925.4,52637888.0,0.073443778747354,0,1,2,3,0,2,2,4,1.0346811141259994e-06,7.599089081993564e-08,29
France,FRA,Winter,1972,3865925.4,52637888.0,0.073443778747354,0,1,2,3,0,2,2,4,1.0346811141259994e-06,7.599089081993564e-08,32
United Kingdom,GBR,Summer,1972,3030432.514,56086065.0,0.054031826158601,4,5,9,18,12,10,9,31,1.0229562894664744e-05,5.527219640030014e-07,18
Ghana,GHA,Summer,1972,225528.9099,9365952.0,0.0240796568143847,0,0,1,1,0,0,1,1,4.434021343176811e-06,1.067697122513547e-07,1
India,IND,Summer,1972,122612.4534,582837973.0,0.0002103714223849,0,0,1,1,0,0,1,1,8.155778408068294e-06,1.715742704362195e-09,1
Italy,ITA,Summer,1972,2671137.314,54381345.0,0.0491186327590831,5,3,10,18,15,6,10,31,1.1605543390645771e-05,5.700484237747338e-07,18
Italy,ITA,Summer,1972,2671137.314,54381345.0,0.0491186327590831,5,3,10,18,15,6,10,31,1.1605543390645771e-05,5.700484237747338e-07,36
Italy,ITA,Winter,1972,2671137.314,54381345.0,0.0491186327590831,2,2,1,5,6,4,1,11,4.118096041842048e-06,2.022752471458733e-07,41
Italy,ITA,Winter,1972,2671137.314,54381345.0,0.0491186327590831,2,2,1,5,6,4,1,11,4.118096041842048e-06,2.022752471458733e-07,46
Jamaica,JAM,Summer,1972,978984.9313,1915299.0,0.511139478118038,0,0,1,1,0,0,1,1,1.0214661819892304e-06,5.221116911772e-07,1
Japan,JPN,Summer,1972,2967041.996,107188000.0,0.0276807291487853,13,8,8,29,39,16,8,63,2.1233268718451938e-05,5.877523603388439e-07,29
Japan,JPN,Summer,1972,2967041.996,107188000.0,0.0276807291487853,13,8,8,29,39,16,8,63,2.1233268718451938e-05,5.877523603388439e-07,58
Japan,JPN,Winter,1972,2967041.996,107188000.0,0.0276807291487853,1,1,1,3,3,2,1,6,2.0222160684239943e-06,5.5976415270366095e-08,61
Japan,JPN,Winter,1972,2967041.996,107188000.0,0.0276807291487853,1,1,1,3,3,2,1,6,2.0222160684239943e-06,5.5976415270366095e-08,64
Kenya,KEN,Summer,1972,171005.09170000002,12322903.0,0.0138770135332559,2,3,4,9,6,6,4,16,9.35644654842754e-05,1.2983953537571464e-06,9
"Korea, Rep.",KOR,Summer,1972,324196.2768,33505406.0,0.0096759393633373,0,1,0,1,0,2,0,2,6.169102309690683e-06,5.969185987479156e-08,1
Mexico,MEX,Summer,1972,844174.4381,53543436.0,0.0157661611051632,0,1,0,1,0,2,0,2,2.3691785841104585e-06,3.735285124398815e-08,1
Norway,NOR,Summer,1972,4413575.692000001,3933004.0,1.122189474508544,2,1,1,4,6,2,1,9,2.0391629436226283e-06,2.288327192141173e-06,4
Norway,NOR,Summer,1972,4413575.692000001,3933004.0,1.122189474508544,2,1,1,4,6,2,1,9,2.0391629436226283e-06,2.288327192141173e-06,8
Norway,NOR,Winter,1972,4413575.692000001,3933004.0,1.122189474508544,2,5,5,12,6,10,5,21,4.7580468684528e-06,5.339430114996069e-06,20
Norway,NOR,Winter,1972,4413575.692000001,3933004.0,1.122189474508544,2,5,5,12,6,10,5,21,4.7580468684528e-06,5.339430114996069e-06,32
New Zealand,NZL,Summer,1972,3294648.943,2903900.0,1.1345600547539516,1,1,1,3,3,2,1,6,1.821134847385772e-06,2.0661868521643307e-06,3
Pakistan,PAK,Summer,1972,150617.2113,62509565.0,0.0024095066299053,0,1,0,1,0,2,0,2,1.3278694929601316e-05,3.199510346936505e-08,1
Sweden,SWE,Summer,1972,6027128.499000001,8122300.0,0.7420470185784815,4,6,6,16,12,12,6,30,4.977494673454779e-06,3.693535082427391e-06,16
Sweden,SWE,Summer,1972,6027128.499000001,8122300.0,0.7420470185784815,4,6,6,16,12,12,6,30,4.977494673454779e-06,3.693535082427391e-06,32
Sweden,SWE,Winter,1972,6027128.499000001,8122300.0,0.7420470185784815,1,1,2,4,3,2,2,7,1.161415423806115e-06,8.618248525663913e-07,36
Sweden,SWE,Winter,1972,6027128.499000001,8122300.0,0.7420470185784815,1,1,2,4,3,2,2,7,1.161415423806115e-06,8.618248525663913e-07,40
Tunisia,TUN,Summer,1972,420566.5745,5320148.0,0.0790516682054709,0,1,0,1,0,2,0,2,4.755489668616068e-06,3.759293914379826e-07,1
Turkiye,TUR,Summer,1972,547465.1976,37188035.0,0.0147215414205133,0,1,0,1,0,2,0,2,3.6532002559572393e-06,5.378073888550444e-08,1
Uganda,UGA,Summer,1972,137025.2176,10885563.0,0.0125877933552908,1,1,0,2,3,2,0,5,3.6489633715422026e-05,4.593239688199866e-07,2
United States,USA,Summer,1972,6094017.99,209896000.0,0.0290335117867896,33,31,30,94,99,62,30,191,3.1342211380639527e-05,9.099744635438504e-07,94
United States,USA,Summer,1972,6094017.99,209896000.0,0.0290335117867896,33,31,30,94,99,62,30,191,3.1342211380639527e-05,9.099744635438504e-07,188
United States,USA,Winter,1972,6094017.99,209896000.0,0.0290335117867896,3,2,3,8,9,4,3,16,2.625525560681845e-06,7.622822731257386e-08,196
United States,USA,Winter,1972,6094017.99,209896000.0,0.0290335117867896,3,2,3,8,9,4,3,16,2.625525560681845e-06,7.622822731257386e-08,204
Australia,AUS,Summer,1976,7487078.975000001,14033000.0,0.5335337401125918,0,1,4,5,0,2,4,6,8.013806212054815e-07,4.275636000855127e-07,5
Austria,AUT,Summer,1976,5678386.658000001,7565525.0,0.7505608213574075,0,0,1,1,0,0,1,1,1.761063591171885e-07,1.3217853354525957e-07,1
Austria,AUT,Summer,1976,5678386.658000001,7565525.0,0.7505608213574075,0,0,1,1,0,0,1,1,1.761063591171885e-07,1.3217853354525957e-07,2
Austria,AUT,Winter,1976,5678386.658000001,7565525.0,0.7505608213574075,2,2,2,6,6,4,2,12,2.113276309406262e-06,1.586142402543115e-06,8
Austria,AUT,Winter,1976,5678386.658000001,7565525.0,0.7505608213574075,2,2,2,6,6,4,2,12,2.113276309406262e-06,1.586142402543115e-06,14
Belgium,BEL,Summer,1976,7243047.341,9818227.0,0.7377143898791503,0,3,3,6,0,6,3,9,1.2425709202609505e-06,9.166624483218812e-07,6
Brazil,BRA,Summer,1976,1376347.9279999998,111286504.0,0.0123676086365333,0,0,2,2,0,0,2,2,1.4531209437037058e-06,1.79716311332774e-08,2
Canada,CAN,Summer,1976,8809264.66,23449808.0,0.3756646817747932,0,5,6,11,0,10,6,16,1.8162696453712856e-06,6.823083583456205e-07,11
Canada,CAN,Summer,1976,8809264.66,23449808.0,0.3756646817747932,0,5,6,11,0,10,6,16,1.8162696453712856e-06,6.823083583456205e-07,22
Canada,CAN,Winter,1976,8809264.66,23449808.0,0.3756646817747932,1,1,1,3,3,2,1,6,6.811011170142321e-07,2.5586563437960773e-07,25
Canada,CAN,Winter,1976,8809264.66,23449808.0,0.3756646817747932,1,1,1,3,3,2,1,6,6.811011170142321e-07,2.5586563437960773e-07,28
Cuba,CUB,Summer,1976,1436285.607,9600862.0,0.1495996512604805,6,4,3,13,18,8,3,29,2.0190970276846893e-05,3.0205621120270243e-06,13
Spain,ESP,Summer,1976,3279312.671,36137812.0,0.090744638081575,0,2,0,2,0,4,0,4,1.2197677993237016e-06,1.1068738749318859e-07,2
Finland,FIN,Summer,1976,6739690.713,4725664.0,1.426189147810763,4,2,0,6,12,4,0,16,2.373996178954926e-06,3.3857675873697325e-06,6
Finland,FIN,Summer,1976,6739690.713,4725664.0,1.426189147810763,4,2,0,6,12,4,0,16,2.373996178954926e-06,3.3857675873697325e-06,12
Finland,FIN,Winter,1976,6739690.713,4725664.0,1.426189147810763,2,4,1,7,6,8,1,15,2.225621417770243e-06,3.174157113159124e-06,19
Finland,FIN,Winter,1976,6739690.713,4725664.0,1.426189147810763,2,4,1,7,6,8,1,15,2.225621417770243e-06,3.174157113159124e-06,26
France,FRA,Summer,1976,6899069.578,53966558.0,0.1278397184048684,2,3,4,9,6,6,4,16,2.319153303080371e-06,2.964799052035151e-07,9
France,FRA,Summer,1976,6899069.578,53966558.0,0.1278397184048684,2,3,4,9,6,6,4,16,2.319153303080371e-06,2.964799052035151e-07,18
France,FRA,Winter,1976,6899069.578,53966558.0,0.1278397184048684,0,0,1,1,0,0,1,1,1.449470814425232e-07,1.852999407521969e-08,19
France,FRA,Winter,1976,6899069.578,53966558.0,0.1278397184048684,0,0,1,1,0,0,1,1,1.449470814425232e-07,1.852999407521969e-08,20
United Kingdom,GBR,Summer,1976,4138167.788,56211968.0,0.0736172017318447,3,5,5,13,9,10,5,24,5.799668169472494e-06,4.269553416098152e-07,13
United Kingdom,GBR,Summer,1976,4138167.788,56211968.0,0.0736172017318447,3,5,5,13,9,10,5,24,5.799668169472494e-06,4.269553416098152e-07,26
United Kingdom,GBR,Winter,1976,4138167.788,56211968.0,0.0736172017318447,1,0,0,1,3,0,0,3,7.249585211840618e-07,5.3369417701226896e-08,27
United Kingdom,GBR,Winter,1976,4138167.788,56211968.0,0.0736172017318447,1,0,0,1,3,0,0,3,7.249585211840618e-07,5.3369417701226896e-08,28
Italy,ITA,Summer,1976,4033099.354,55718260.0,0.072383799386413,2,7,4,13,6,14,4,24,5.95075843499788e-06,4.307385047558915e-07,13
Italy,ITA,Summer,1976,4033099.354,55718260.0,0.072383799386413,2,7,4,13,6,14,4,24,5.95075843499788e-06,4.307385047558915e-07,26
Italy,ITA,Winter,1976,4033099.354,55718260.0,0.072383799386413,1,2,1,4,3,4,1,8,1.9835861449992936e-06,1.4357950158529718e-07,30
Italy,ITA,Winter,1976,4033099.354,55718260.0,0.072383799386413,1,2,1,4,3,4,1,8,1.9835861449992936e-06,1.4357950158529718e-07,34
Jamaica,JAM,Summer,1976,1461458.8269999998,2029486.0,0.7201127906277747,1,1,0,2,3,2,0,5,3.421239043910473e-06,2.46367799531507e-06,2
Japan,JPN,Summer,1976,5197622.336999999,112775000.0,0.0460884268410551,9,6,10,25,27,12,10,49,9.427387528945048e-06,4.344934604300599e-07,25
"Korea, Rep.",KOR,Summer,1976,834134.208,35848523.0,0.0232683005656885,1,1,4,6,3,2,4,9,1.0789630629799084e-05,2.510563684869248e-07,6
Liechtenstein,LIE,Winter,1976,11637080.59,23416.0,496.9713268705159,0,0,2,2,0,0,2,2,1.718644108831423e-07,8.541168431841476e-05,2
Mexico,MEX,Summer,1976,1472658.876,60452543.0,0.0243605777841306,1,0,1,2,3,0,1,4,2.7161755279435127e-06,6.616760522381994e-08,2
Norway,NOR,Summer,1976,8927201.627,4026152.0,2.217303675320753,1,1,0,2,3,2,0,5,5.600859271373103e-07,1.2418805847369896e-06,2
Norway,NOR,Summer,1976,8927201.627,4026152.0,2.217303675320753,1,1,0,2,3,2,0,5,5.600859271373103e-07,1.2418805847369896e-06,4
Norway,NOR,Winter,1976,8927201.627,4026152.0,2.217303675320753,3,3,1,7,9,6,1,16,1.792274966839393e-06,3.974017871158367e-06,11
Norway,NOR,Winter,1976,8927201.627,4026152.0,2.217303675320753,3,3,1,7,9,6,1,16,1.792274966839393e-06,3.974017871158367e-06,18
New Zealand,NZL,Summer,1976,4373840.998,3110500.0,1.4061536723999355,2,1,1,4,6,2,1,9,2.057687969022051e-06,2.893425494293522e-06,4
Pakistan,PAK,Summer,1976,187496.9066,70230923.0,0.0026697200975131,0,0,1,1,0,0,1,1,5.3334213248294734e-06,1.4238742099402569e-08,1
Sweden,SWE,Summer,1976,10868275.77,8222286.0,1.3218070704424536,4,1,0,5,12,2,0,14,1.288152812486097e-06,1.702689495354455e-06,5
Sweden,SWE,Summer,1976,10868275.77,8222286.0,1.3218070704424536,4,1,0,5,12,2,0,14,1.288152812486097e-06,1.702689495354455e-06,10
Sweden,SWE,Winter,1976,10868275.77,8222286.0,1.3218070704424536,0,0,2,2,0,0,2,2,1.840218303551567e-07,2.432413564792078e-07,12
Sweden,SWE,Winter,1976,10868275.77,8222286.0,1.3218070704424536,0,0,2,2,0,0,2,2,1.840218303551567e-07,2.432413564792078e-07,14
Thailand,THA,Summer,1976,405547.9499,41882128.0,0.0096830788994293,0,0,1,1,0,0,1,1,2.465799667453824e-06,2.3876532730142082e-08,1
Trinidad and Tobago,TTO,Summer,1976,2341875.013,1067696.0,2.1933912021773985,1,0,0,1,3,0,0,3,1.2810248127447784e-06,2.8097885540453463e-06,1
United States,USA,Summer,1976,8592253.537,218035000.0,0.039407680129337,34,35,25,94,102,70,25,197,2.2927628840522188e-05,9.03524663471461e-07,94
United States,USA,Summer,1976,8592253.537,218035000.0,0.039407680129337,34,35,25,94,102,70,25,197,2.2927628840522188e-05,9.03524663471461e-07,188
United States,USA,Winter,1976,8592253.537,218035000.0,0.039407680129337,3,3,4,10,9,6,4,19,2.2112941521315818e-06,8.714197261907493e-08,198
United States,USA,Winter,1976,8592253.537,218035000.0,0.039407680129337,3,3,4,10,9,6,4,19,2.2112941521315818e-06,8.714197261907493e-08,208
"Venezuela, RB",VEN,Summer,1976,2316030.922,13566112.0,0.1707217898540126,0,1,0,1,0,2,0,2,8.635463287652945e-07,1.4742617486867277e-07,1
Australia,AUS,Summer,1980,10208576.17,14692000.0,0.6948391076776477,2,2,5,9,6,4,5,15,1.4693528020176392e-06,1.0209637898175878e-06,9
Austria,AUT,Summer,1980,10869546.49,7549433.0,1.4397831585497878,1,2,1,4,3,4,1,8,7.360012680713048e-07,1.0596822304403522e-06,4
Austria,AUT,Summer,1980,10869546.49,7549433.0,1.4397831585497878,1,2,1,4,3,4,1,8,7.360012680713048e-07,1.0596822304403522e-06,8
Austria,AUT,Winter,1980,10869546.49,7549433.0,1.4397831585497878,3,2,2,7,9,4,2,15,1.3800023776336964e-06,1.9869041820756605e-06,15
Austria,AUT,Winter,1980,10869546.49,7549433.0,1.4397831585497878,3,2,2,7,9,4,2,15,1.3800023776336964e-06,1.9869041820756605e-06,22
Belgium,BEL,Summer,1980,12864002.57,9859242.0,1.304765880581895,1,0,0,1,3,0,0,3,2.3320890863285955e-07,3.042830270318956e-07,1
Brazil,BRA,Summer,1980,1941259.538,122288383.0,0.0158744395042004,2,0,2,4,6,0,2,8,4.121035772600542e-06,6.541913306679345e-08,4
Canada,CAN,Winter,1980,11170563.97,24515667.0,0.4556500122962185,0,1,1,2,0,2,1,3,2.685629846493776e-07,1.2237072725779804e-07,2
Cuba,CUB,Summer,1980,2030041.049,9809107.0,0.2069547257461866,8,7,5,20,24,14,5,43,2.11818376880516e-05,4.383681409530959e-06,20
Spain,ESP,Summer,1980,6208578.018999999,37491165.0,0.1656010961249137,1,3,2,6,3,6,2,11,1.7717422518227038e-06,2.934024589526626e-07,6
Finland,FIN,Summer,1980,11223937.56,4779535.0,2.34833253862562,3,1,4,8,9,2,4,15,1.3364293876203638e-06,3.1383806165244107e-06,8
Finland,FIN,Summer,1980,11223937.56,4779535.0,2.34833253862562,3,1,4,8,9,2,4,15,1.3364293876203638e-06,3.1383806165244107e-06,16
Finland,FIN,Winter,1980,11223937.56,4779535.0,2.34833253862562,1,5,3,9,3,10,3,16,1.425524680128388e-06,3.3476059909593714e-06,25
Finland,FIN,Winter,1980,11223937.56,4779535.0,2.34833253862562,1,5,3,9,3,10,3,16,1.425524680128388e-06,3.3476059909593714e-06,34
France,FRA,Summer,1980,12738520.05,55052582.0,0.2313882398830993,6,5,3,14,18,10,3,31,2.433563701145959e-06,5.630980214515643e-07,14
France,FRA,Summer,1980,12738520.05,55052582.0,0.2313882398830993,6,5,3,14,18,10,3,31,2.433563701145959e-06,5.630980214515643e-07,28
France,FRA,Winter,1980,12738520.05,55052582.0,0.2313882398830993,0,0,1,1,0,0,1,1,7.85020548756761e-08,1.816445230488917e-08,29
France,FRA,Winter,1980,12738520.05,55052582.0,0.2313882398830993,0,0,1,1,0,0,1,1,7.85020548756761e-08,1.816445230488917e-08,30
United Kingdom,GBR,Summer,1980,10032062.08,56314216.0,0.1781443974999137,5,7,9,21,15,14,9,38,3.787855347880782e-06,6.747852087650479e-07,21
United Kingdom,GBR,Summer,1980,10032062.08,56314216.0,0.1781443974999137,5,7,9,21,15,14,9,38,3.787855347880782e-06,6.747852087650479e-07,42
United Kingdom,GBR,Winter,1980,10032062.08,56314216.0,0.1781443974999137,1,0,0,1,3,0,0,3,2.9904121167479855e-07,5.3272516481451146e-08,43
United Kingdom,GBR,Winter,1980,10032062.08,56314216.0,0.1781443974999137,1,0,0,1,3,0,0,3,2.9904121167479855e-07,5.3272516481451146e-08,44
Guyana,GUY,Summer,1980,775145.9824,778176.0,0.9961062566822928,0,0,1,1,0,0,1,1,1.290079575596598e-06,1.2850563368698084e-06,1
India,IND,Summer,1980,267390.5787,696828385.0,0.0003837251530733,1,0,0,1,3,0,0,3,1.1219542642771504e-05,4.305220718010791e-09,1
Ireland,IRL,Summer,1980,6372437.775,3412800.0,1.867216882032349,0,1,1,2,0,2,1,3,4.707774490587317e-07,8.790436005625879e-07,2
Italy,ITA,Summer,1980,8456918.974,56433883.0,0.1498553444213647,8,3,4,15,24,6,4,34,4.0203767003715885e-06,6.024749351378142e-07,15
Italy,ITA,Summer,1980,8456918.974,56433883.0,0.1498553444213647,8,3,4,15,24,6,4,34,4.0203767003715885e-06,6.024749351378142e-07,30
Italy,ITA,Winter,1980,8456918.974,56433883.0,0.1498553444213647,0,2,0,2,0,4,0,4,4.729854941613634e-07,7.08794041338605e-08,32
Italy,ITA,Winter,1980,8456918.974,56433883.0,0.1498553444213647,0,2,0,2,0,4,0,4,4.729854941613634e-07,7.08794041338605e-08,34
Jamaica,JAM,Summer,1980,1254671.851,2135546.0,0.5875180637644892,0,0,3,3,0,0,3,3,2.3910634462779543e-06,1.4047929662952706e-06,3
Japan,JPN,Winter,1980,9463353.855,116807000.0,0.0810170097254445,0,1,0,1,0,2,0,2,2.113415635349293e-07,1.7122261508300015e-08,1
Liechtenstein,LIE,Winter,1980,21385510.36,25003.0,855.317776266848,2,2,0,4,6,4,0,10,4.6760632931651966e-07,0.0003999520057593,4
Mexico,MEX,Summer,1980,3029887.355,67705186.0,0.044751185751118,0,1,3,4,0,2,3,5,1.650226366253804e-06,7.384958664761664e-08,4
Norway,NOR,Winter,1980,15772240.91,4085620.0,3.860427771060451,1,3,6,10,3,6,6,15,9.51037971433065e-07,3.6714133962532e-06,10
Sweden,SWE,Summer,1980,17097832.65,8310531.0,2.05736945689752,3,3,6,12,9,6,6,21,1.2282258476778343e-06,2.526914345184441e-06,12
Sweden,SWE,Summer,1980,17097832.65,8310531.0,2.05736945689752,3,3,6,12,9,6,6,21,1.2282258476778343e-06,2.526914345184441e-06,24
Sweden,SWE,Winter,1980,17097832.65,8310531.0,2.05736945689752,3,0,1,4,9,0,1,10,5.848694512751592e-07,1.2032925453259245e-06,28
Sweden,SWE,Winter,1980,17097832.65,8310531.0,2.05736945689752,3,0,1,4,9,0,1,10,5.848694512751592e-07,1.2032925453259245e-06,32
Uganda,UGA,Summer,1980,93692.22855,13284026.0,0.0070529994859991,0,1,0,1,0,2,0,2,2.134648765380445e-05,1.5055676645017105e-07,1
United States,USA,Winter,1980,12574791.51,227225000.0,0.0553407041918802,6,4,2,12,18,8,2,28,2.226677076731907e-06,1.232258774342612e-07,12
"Venezuela, RB",VEN,Summer,1980,3886573.956,15210443.0,0.2555201026031918,0,1,0,1,0,2,0,2,5.145920346922635e-07,1.314886095033524e-07,1
Australia,AUS,Summer,1984,12421492.6,15579391.0,0.7973028342378723,4,8,12,24,12,16,12,40,3.220224918863616e-06,2.5674944546933837e-06,24
Austria,AUT,Summer,1984,8991065.04,7561434.0,1.1890687718758108,1,1,1,3,3,2,1,6,6.673291732744489e-07,7.935002805023492e-07,3
Austria,AUT,Summer,1984,8991065.04,7561434.0,1.1890687718758108,1,1,1,3,3,2,1,6,6.673291732744489e-07,7.935002805023492e-07,6
Austria,AUT,Winter,1984,8991065.04,7561434.0,1.1890687718758108,0,0,1,1,0,0,1,1,1.1122152887907485e-07,1.3225004675039153e-07,7
Austria,AUT,Winter,1984,8991065.04,7561434.0,1.1890687718758108,0,0,1,1,0,0,1,1,1.1122152887907485e-07,1.3225004675039153e-07,8
Belgium,BEL,Summer,1984,8457268.803000001,9855372.0,0.8581379579583603,1,1,2,4,3,2,2,7,8.276903765334889e-07,7.102725295402345e-07,4
Brazil,BRA,Summer,1984,1406689.8,133888775.0,0.0105064057834572,1,5,2,8,3,10,2,15,1.0663331745207793e-05,1.1203329031877393e-07,8
Canada,CAN,Summer,1984,13877917.08,25607053.0,0.5419568225988364,10,18,16,44,30,36,16,82,5.908667671618629e-06,3.2022427571028967e-06,44
Canada,CAN,Summer,1984,13877917.08,25607053.0,0.5419568225988364,10,18,16,44,30,36,16,82,5.908667671618629e-06,3.2022427571028967e-06,88
Canada,CAN,Winter,1984,13877917.08,25607053.0,0.5419568225988364,2,1,1,4,6,2,1,9,6.485123054215568e-07,3.514656684625131e-07,92
Canada,CAN,Winter,1984,13877917.08,25607053.0,0.5419568225988364,2,1,1,4,6,2,1,9,6.485123054215568e-07,3.514656684625131e-07,96
China,CHN,Summer,1984,250713.969,1036825000.0,0.0002418093400525,15,8,9,32,45,16,9,70,0.0002792026319044,6.751380416174378e-08,32
Cote d'Ivoire,CIV,Summer,1984,711085.2016,9621405.0,0.073906586574414,0,1,0,1,0,2,0,2,2.812602477874432e-06,2.0786984853043813e-07,1
Cameroon,CMR,Summer,1984,768983.9227,9508570.0,0.0808727203669952,0,0,1,1,0,0,1,1,1.3004173045502349e-06,1.0516828503129283e-07,1
Colombia,COL,Summer,1984,1333370.911,28689032.0,0.0464766782999161,0,1,0,1,0,2,0,2,1.4999577263164098e-06,6.971305270948145e-08,1
Dominican Republic,DOM,Summer,1984,1845560.023,6282104.0,0.2937805587109032,0,0,1,1,0,0,1,1,5.418409520891534e-07,1.5918233763719928e-07,1
"Egypt, Arab Rep.",EGY,Summer,1984,697897.9336999999,48676443.0,0.0143374883349631,0,1,0,1,0,2,0,2,2.8657485621095486e-06,4.108763658018315e-08,1
Spain,ESP,Summer,1984,4489988.939,38330364.0,0.1171392199406194,1,2,2,5,3,4,2,9,2.004459280918509e-06,2.3480079656952906e-07,5
Finland,FIN,Summer,1984,10833866.29,4881803.0,2.219234633187779,4,2,6,12,12,4,6,22,2.030669329960874e-06,4.5065317056013935e-06,12
Finland,FIN,Summer,1984,10833866.29,4881803.0,2.219234633187779,4,2,6,12,12,4,6,22,2.030669329960874e-06,4.5065317056013935e-06,24
Finland,FIN,Winter,1984,10833866.29,4881803.0,2.219234633187779,4,3,6,13,12,6,6,24,2.21527563268459e-06,4.916216406110612e-06,37
Finland,FIN,Winter,1984,10833866.29,4881803.0,2.219234633187779,4,3,6,13,12,6,6,24,2.21527563268459e-06,4.916216406110612e-06,50
France,FRA,Summer,1984,9430069.648,56275701.0,0.1675691191834287,5,7,16,28,15,14,16,45,4.771968997020498e-06,7.996346416013548e-07,28
France,FRA,Summer,1984,9430069.648,56275701.0,0.1675691191834287,5,7,16,28,15,14,16,45,4.771968997020498e-06,7.996346416013548e-07,56
France,FRA,Winter,1984,9430069.648,56275701.0,0.1675691191834287,0,1,2,3,0,2,2,4,4.241750219573776e-07,7.107863480900931e-08,59
France,FRA,Winter,1984,9430069.648,56275701.0,0.1675691191834287,0,1,2,3,0,2,2,4,4.241750219573776e-07,7.107863480900931e-08,62
United Kingdom,GBR,Summer,1984,8179194.441,56422072.0,0.1449644465555961,5,11,21,37,15,22,21,58,7.091162878982596e-06,1.0279665021873e-06,37
United Kingdom,GBR,Summer,1984,8179194.441,56422072.0,0.1449644465555961,5,11,21,37,15,22,21,58,7.091162878982596e-06,1.0279665021873e-06,74
United Kingdom,GBR,Winter,1984,8179194.441,56422072.0,0.1449644465555961,1,0,0,1,3,0,0,3,3.667842868439274e-07,5.3170681147618964e-08,75
United Kingdom,GBR,Winter,1984,8179194.441,56422072.0,0.1449644465555961,1,0,0,1,3,0,0,3,3.667842868439274e-07,5.3170681147618964e-08,76
Ireland,IRL,Summer,1984,5692027.386,3532423.0,1.6113663018273858,0,1,0,1,0,2,0,2,3.513686537979704e-07,5.661836082485025e-07,1
Iceland,ISL,Summer,1984,11959540.01,239511.0,49.93315551269044,0,0,1,1,0,0,1,1,8.361525603525282e-08,4.175173582841706e-06,1
Italy,ITA,Summer,1984,7739715.284,56576718.0,0.1368003581261111,14,6,12,32,42,12,12,66,8.527445465137345e-06,1.1665575935316716e-06,32
Italy,ITA,Summer,1984,7739715.284,56576718.0,0.1368003581261111,14,6,12,32,42,12,12,66,8.527445465137345e-06,1.1665575935316716e-06,64
Italy,ITA,Winter,1984,7739715.284,56576718.0,0.1368003581261111,2,0,0,2,6,0,0,6,7.75222315012486e-07,1.0605069032106105e-07,66
Italy,ITA,Winter,1984,7739715.284,56576718.0,0.1368003581261111,2,0,0,2,6,0,0,6,7.75222315012486e-07,1.0605069032106105e-07,68
Jamaica,JAM,Summer,1984,1048351.309,2264095.0,0.4630332689220195,0,1,2,3,0,2,2,4,3.815514861917342e-06,1.7667103191341353e-06,3
Japan,JPN,Summer,1984,10978919.81,120083000.0,0.0914277608820565,10,8,14,32,30,16,14,60,5.465018511689084e-06,4.996544057027223e-07,32
Japan,JPN,Summer,1984,10978919.81,120083000.0,0.0914277608820565,10,8,14,32,30,16,14,60,5.465018511689084e-06,4.996544057027223e-07,64
Japan,JPN,Winter,1984,10978919.81,120083000.0,0.0914277608820565,0,1,0,1,0,2,0,2,1.821672837229695e-07,1.665514685675741e-08,65
Japan,JPN,Winter,1984,10978919.81,120083000.0,0.0914277608820565,0,1,0,1,0,2,0,2,1.821672837229695e-07,1.665514685675741e-08,66
Kenya,KEN,Summer,1984,330154.05340000003,18753176.0,0.017605234089415,1,0,2,3,3,0,2,5,1.5144445293065116e-05,2.666215045387512e-07,3
"Korea, Rep.",KOR,Summer,1984,2413263.9250000003,40405956.0,0.0597254505004163,6,6,7,19,18,12,7,37,1.5331932664596557e-05,9.15706585435078e-07,19
Liechtenstein,LIE,Winter,1984,19024123.97,26420.0,720.0652524602573,0,0,2,2,0,0,2,2,1.0512967657033198e-07,7.57002271006813e-05,2
Morocco,MAR,Summer,1984,675019.2871000001,21817271.0,0.030939675594624,2,0,0,2,6,0,0,6,8.888634909643901e-06,2.750114805834332e-07,2
Mexico,MEX,Summer,1984,2507312.061,73489654.0,0.0341178917647373,2,3,1,6,6,6,1,13,5.184835267300219e-06,1.7689564846774217e-07,6
Norway,NOR,Summer,1984,14989485.77,4140099.0,3.6205621580546734,0,1,2,3,0,2,2,4,2.6685371742409015e-07,9.66160471041876e-07,3
Norway,NOR,Summer,1984,14989485.77,4140099.0,3.6205621580546734,0,1,2,3,0,2,2,4,2.6685371742409015e-07,9.66160471041876e-07,6
Norway,NOR,Winter,1984,14989485.77,4140099.0,3.6205621580546734,3,2,4,9,9,4,4,17,1.134128299052383e-06,4.106182001927973e-06,15
Norway,NOR,Winter,1984,14989485.77,4140099.0,3.6205621580546734,3,2,4,9,9,4,4,17,1.134128299052383e-06,4.106182001927973e-06,24
New Zealand,NZL,Summer,1984,6713760.131,3227100.0,2.080431387623563,8,1,2,11,24,2,2,28,4.170539228935703e-06,8.676520715193208e-06,11
Pakistan,PAK,Summer,1984,331388.7658,94003867.0,0.0035252673786281,1,0,0,1,3,0,0,3,9.052811409456658e-06,3.1913580746630356e-08,1
Peru,PER,Summer,1984,911789.2245,19285646.0,0.0472781271884799,0,1,0,1,0,2,0,2,2.193489401124196e-06,1.037040708929325e-07,1
Sweden,SWE,Summer,1984,13099020.83,8336605.0,1.5712656207173064,2,11,6,19,6,22,6,34,2.5956138585665565e-06,4.078398820623023e-06,19
Sweden,SWE,Summer,1984,13099020.83,8336605.0,1.5712656207173064,2,11,6,19,6,22,6,34,2.5956138585665565e-06,4.078398820623023e-06,38
Sweden,SWE,Winter,1984,13099020.83,8336605.0,1.5712656207173064,4,2,2,8,12,4,2,18,1.3741485133587653e-06,2.159152316800424e-06,46
Sweden,SWE,Winter,1984,13099020.83,8336605.0,1.5712656207173064,4,2,2,8,12,4,2,18,1.3741485133587653e-06,2.159152316800424e-06,54
Syrian Arab Republic,SYR,Summer,1984,1885019.531,10183138.0,0.18511185167087,0,1,0,1,0,2,0,2,1.0609969642802602e-06,1.964031126750909e-07,1
Thailand,THA,Summer,1984,842069.9352000001,49636724.0,0.0169646557496421,0,1,0,1,0,2,0,2,2.375099640061345e-06,4.029274776473967e-08,1
Turkiye,TUR,Summer,1984,1247016.105,48106764.0,0.0259218455225963,0,0,3,3,0,0,3,3,2.4057427870989686e-06,6.23612928942799e-08,3
United States,USA,Summer,1984,17121225.48,235825000.0,0.0726014013781405,83,61,30,174,249,122,30,401,2.342122066369749e-05,1.7004134421711014e-06,174
United States,USA,Summer,1984,17121225.48,235825000.0,0.0726014013781405,83,61,30,174,249,122,30,401,2.342122066369749e-05,1.7004134421711014e-06,348
United States,USA,Winter,1984,17121225.48,235825000.0,0.0726014013781405,4,4,0,8,12,8,0,20,1.1681406814811716e-06,8.48086504823492e-08,356
United States,USA,Winter,1984,17121225.48,235825000.0,0.0726014013781405,4,4,0,8,12,8,0,20,1.1681406814811716e-06,8.48086504823492e-08,364
"Venezuela, RB",VEN,Summer,1984,3539754.463,16953234.0,0.20879523417184,0,0,3,3,0,0,3,3,8.475164114794139e-07,1.7695738759932178e-07,3
Argentina,ARG,Summer,1988,3982444.402,31690792.0,0.125665663452021,0,1,1,2,0,2,1,3,7.533061851393048e-07,9.466472153804172e-08,2
Australia,AUS,Summer,1988,14284515.81,16532164.0,0.8640439212918527,3,6,5,14,9,12,5,26,1.8201526986163908e-06,1.572691875062454e-06,14
Austria,AUT,Summer,1988,17578618.94,7585317.0,2.317453435367302,1,0,0,1,3,0,0,3,1.7066187111966601e-07,3.955009395124818e-07,1
Austria,AUT,Summer,1988,17578618.94,7585317.0,2.317453435367302,1,0,0,1,3,0,0,3,1.7066187111966601e-07,3.955009395124818e-07,2
Austria,AUT,Winter,1988,17578618.94,7585317.0,2.317453435367302,3,5,2,10,9,10,2,21,1.194633097837662e-06,2.768506576587373e-06,12
Austria,AUT,Winter,1988,17578618.94,7585317.0,2.317453435367302,3,5,2,10,9,10,2,21,1.194633097837662e-06,2.768506576587373e-06,22
Belgium,BEL,Summer,1988,16391093.830000002,9901664.0,1.6553878045144736,0,0,2,2,0,0,2,2,1.2201748222192928e-07,2.0198625200774334e-07,2
Brazil,BRA,Summer,1988,1781817.8760000002,145253973.0,0.0122669131810941,1,2,3,6,3,4,3,10,5.61224586120383e-06,6.88449327303426e-08,6
Canada,CAN,Summer,1988,18936964.1,26791747.0,0.7068208019432254,3,2,5,10,9,4,5,18,9.505219477075524e-07,6.718486853432888e-07,10
Canada,CAN,Summer,1988,18936964.1,26791747.0,0.7068208019432254,3,2,5,10,9,4,5,18,9.505219477075524e-07,6.718486853432888e-07,20
Canada,CAN,Winter,1988,18936964.1,26791747.0,0.7068208019432254,0,2,3,5,0,4,3,7,3.696474241084927e-07,2.612744887446123e-07,25
Canada,CAN,Winter,1988,18936964.1,26791747.0,0.7068208019432254,0,2,3,5,0,4,3,7,3.696474241084927e-07,2.612744887446123e-07,30
China,CHN,Summer,1988,283537.6952,1101630000.0,0.0002573801505042,5,11,12,28,15,22,12,49,0.0001728165278533,4.4479543948512664e-08,28
Colombia,COL,Summer,1988,1254531.546,31256727.0,0.0401363695565437,0,0,1,1,0,0,1,1,7.971102864558817e-07,3.1993113034515746e-08,1
Djibouti,DJI,Summer,1988,820576.7723000001,482337.0,1.7012519717541883,0,0,1,1,0,0,1,1,1.2186550165161187e-06,2.0732392497361803e-06,1
Spain,ESP,Summer,1988,9703123.838,38766939.0,0.2502937835251836,1,1,2,4,3,2,2,7,7.214171556366362e-07,1.8056622938426998e-07,4
Finland,FIN,Summer,1988,22047793.32,4946481.0,4.4572683732132,1,1,2,4,3,2,2,7,3.17492090859277e-07,1.4151474553323868e-06,4
Finland,FIN,Summer,1988,22047793.32,4946481.0,4.4572683732132,1,1,2,4,3,2,2,7,3.17492090859277e-07,1.4151474553323868e-06,8
Finland,FIN,Winter,1988,22047793.32,4946481.0,4.4572683732132,4,1,2,7,12,2,2,16,7.256962076783474e-07,3.234622755045456e-06,15
Finland,FIN,Winter,1988,22047793.32,4946481.0,4.4572683732132,4,1,2,7,12,2,2,16,7.256962076783474e-07,3.234622755045456e-06,22
France,FRA,Summer,1988,17727510.83,57472651.0,0.3084512463153996,6,4,6,16,18,8,6,32,1.8051039599900783e-06,5.56786566187803e-07,16
France,FRA,Summer,1988,17727510.83,57472651.0,0.3084512463153996,6,4,6,16,18,8,6,32,1.8051039599900783e-06,5.56786566187803e-07,32
France,FRA,Winter,1988,17727510.83,57472651.0,0.3084512463153996,1,0,1,2,3,0,1,4,2.2563799499875987e-07,6.959832077347537e-08,34
France,FRA,Winter,1988,17727510.83,57472651.0,0.3084512463153996,1,0,1,2,3,0,1,4,2.2563799499875987e-07,6.959832077347537e-08,36
United Kingdom,GBR,Summer,1988,15987168.08,56928327.0,0.2808297542276273,5,10,9,24,15,20,9,44,2.7522072564586435e-06,7.729016874147733e-07,24
Italy,ITA,Summer,1988,15744661.260000002,56629288.0,0.2780303587783057,6,4,4,14,18,8,4,30,1.9054077762991515e-06,5.297612076634268e-07,14
Italy,ITA,Summer,1988,15744661.260000002,56629288.0,0.2780303587783057,6,4,4,14,18,8,4,30,1.9054077762991515e-06,5.297612076634268e-07,28
Italy,ITA,Winter,1988,15744661.260000002,56629288.0,0.2780303587783057,2,1,2,5,6,2,2,10,6.351359254330505e-07,1.7658706922114225e-07,33
Italy,ITA,Winter,1988,15744661.260000002,56629288.0,0.2780303587783057,2,1,2,5,6,2,2,10,6.351359254330505e-07,1.7658706922114225e-07,38
Jamaica,JAM,Summer,1988,1625744.27,2354805.0,0.6903944360573381,0,2,0,2,0,4,0,4,2.4604115627607288e-06,1.6986544533411472e-06,2
Japan,JPN,Summer,1988,25059007.43,122578000.0,0.2044331562760038,4,3,7,14,12,6,7,25,9.97645260684613e-07,2.039517694855521e-07,14
Japan,JPN,Summer,1988,25059007.43,122578000.0,0.2044331562760038,4,3,7,14,12,6,7,25,9.97645260684613e-07,2.039517694855521e-07,28
Japan,JPN,Winter,1988,25059007.43,122578000.0,0.2044331562760038,0,0,1,1,0,0,1,1,3.990581042738452e-08,8.158070779422083e-09,29
Japan,JPN,Winter,1988,25059007.43,122578000.0,0.2044331562760038,0,0,1,1,0,0,1,1,3.990581042738452e-08,8.158070779422083e-09,30
Kenya,KEN,Summer,1988,386355.9486,21626122.0,0.0178652441061786,5,2,2,9,15,4,2,21,5.435402269874615e-05,9.71047883665874e-07,9
"Korea, Rep.",KOR,Summer,1988,4748629.608,42031247.0,0.1129785563583207,12,10,11,33,36,20,11,67,1.4109333751178515e-05,1.594052158385879e-06,33
Liechtenstein,LIE,Winter,1988,41574494.38,27944.0,1487.7789285714284,0,0,1,1,0,0,1,1,2.4053208942477583e-08,3.5785857429144e-05,1
Morocco,MAR,Summer,1988,1076092.773,23720590.0,0.0453653460137374,1,0,2,3,3,0,2,5,4.64643953147337e-06,2.107873370771975e-07,3
Mexico,MEX,Summer,1988,2302027.017,78892015.0,0.0291794678713682,0,0,2,2,0,0,2,2,8.687995341628955e-07,2.5351108093765893e-08,2
Norway,NOR,Summer,1988,24207281.470000003,4209488.0,5.750647458788338,2,3,0,5,6,6,0,12,4.957186132144396e-07,2.8507029833556954e-06,5
Norway,NOR,Summer,1988,24207281.470000003,4209488.0,5.750647458788338,2,3,0,5,6,6,0,12,4.957186132144396e-07,2.8507029833556954e-06,10
Norway,NOR,Winter,1988,24207281.470000003,4209488.0,5.750647458788338,0,3,2,5,0,6,2,8,3.30479075476293e-07,1.900468655570464e-06,15
Norway,NOR,Winter,1988,24207281.470000003,4209488.0,5.750647458788338,0,3,2,5,0,6,2,8,3.30479075476293e-07,1.900468655570464e-06,20
New Zealand,NZL,Summer,1988,13759155.63,3283400.0,4.190520688920022,3,2,8,13,9,4,8,21,1.5262564480492036e-06,6.395809222147774e-06,13
Pakistan,PAK,Summer,1988,356335.2154,107967838.0,0.0033003829844217,0,0,1,1,0,0,1,1,2.8063462626826302e-06,9.262017453753218e-09,1
Peru,PER,Summer,1988,730209.7626,21143799.0,0.0345354097719146,0,1,0,1,0,2,0,2,2.738939004155133e-06,9.459038084877747e-08,1
Romania,ROU,Summer,1988,1769889.931,23057662.0,0.0767592972349061,7,11,6,24,21,22,6,49,2.7685337456162972e-05,2.1251070468462936e-06,24
Senegal,SEN,Summer,1988,902269.9219,7113636.0,0.1268366728210439,0,1,0,1,0,2,0,2,2.2166315771542068e-06,2.811501741163028e-07,1
Suriname,SUR,Summer,1988,2887061.439,402139.0,7.179262491327626,1,0,0,1,3,0,0,3,1.0391188630329664e-06,7.460107077403584e-06,1
Sweden,SWE,Summer,1988,24534693.82,8436489.0,2.908164026528097,0,4,7,11,0,8,7,15,6.113791396806598e-07,1.7779908205889917e-06,11
Sweden,SWE,Summer,1988,24534693.82,8436489.0,2.908164026528097,0,4,7,11,0,8,7,15,6.113791396806598e-07,1.7779908205889917e-06,22
Sweden,SWE,Winter,1988,24534693.82,8436489.0,2.908164026528097,4,0,2,6,12,0,2,14,5.706205303686157e-07,1.659458099216392e-06,28
Sweden,SWE,Winter,1988,24534693.82,8436489.0,2.908164026528097,4,0,2,6,12,0,2,14,5.706205303686157e-07,1.659458099216392e-06,34
Thailand,THA,Summer,1988,1154579.398,53410965.0,0.021616898290454,0,0,1,1,0,0,1,1,8.66116268601564e-07,1.872274728606757e-08,1
Turkiye,TUR,Summer,1988,1737948.68,52275890.0,0.033245702368721,1,1,0,2,3,2,0,5,2.876954916758532e-06,9.564638689078273e-08,2
United States,USA,Summer,1988,21417011.93,244499000.0,0.0875954990817958,36,31,27,94,108,62,27,197,9.198295291793304e-06,8.057292667863672e-07,94
United States,USA,Summer,1988,21417011.93,244499000.0,0.0875954990817958,36,31,27,94,108,62,27,197,9.198295291793304e-06,8.057292667863672e-07,188
United States,USA,Winter,1988,21417011.93,244499000.0,0.0875954990817958,2,1,3,6,6,2,3,11,5.13610397003687e-07,4.4989959059137264e-08,194
United States,USA,Winter,1988,21417011.93,244499000.0,0.0875954990817958,2,1,3,6,6,2,3,11,5.13610397003687e-07,4.4989959059137264e-08,200
Argentina,ARG,Summer,1992,6815618.29,33568285.0,0.2030374292282134,0,0,1,1,0,0,1,1,1.467218317474173e-07,2.9790023529650084e-08,1
Australia,AUS,Summer,1992,18624555.08,17478635.0,1.0655611882735694,7,9,11,27,21,18,11,50,2.684627889645136e-06,2.860635284162636e-06,27
Austria,AUT,Summer,1992,24880164.12,7840709.0,3.173203356992333,0,2,0,2,0,4,0,4,1.607706436624583e-07,5.101579461755308e-07,2
Austria,AUT,Summer,1992,24880164.12,7840709.0,3.173203356992333,0,2,0,2,0,4,0,4,1.607706436624583e-07,5.101579461755308e-07,4
Austria,AUT,Winter,1992,24880164.12,7840709.0,3.173203356992333,6,7,8,21,18,14,8,40,1.6077064366245827e-06,5.101579461755308e-06,25
Austria,AUT,Winter,1992,24880164.12,7840709.0,3.173203356992333,6,7,8,21,18,14,8,40,1.6077064366245827e-06,5.101579461755308e-06,46
Belgium,BEL,Summer,1992,23372619.17,10045158.0,2.326754757864436,0,1,2,3,0,2,2,4,1.7114042593626873e-07,3.982018003101594e-07,3
Brazil,BRA,Summer,1992,2105107.748,155900790.0,0.0135028677404392,2,1,0,3,6,2,0,8,3.800280535569052e-06,5.131468544835469e-08,3
Canada,CAN,Summer,1992,20879848.33,28371264.0,0.7359505847183968,7,4,7,18,21,8,7,36,1.724150455071816e-06,1.268889535552593e-06,18
Canada,CAN,Summer,1992,20879848.33,28371264.0,0.7359505847183968,7,4,7,18,21,8,7,36,1.724150455071816e-06,1.268889535552593e-06,36
Canada,CAN,Winter,1992,20879848.33,28371264.0,0.7359505847183968,2,3,2,7,6,6,2,14,6.705029547501507e-07,4.934570416037861e-07,43
Canada,CAN,Winter,1992,20879848.33,28371264.0,0.7359505847183968,2,3,2,7,6,6,2,14,6.705029547501507e-07,4.934570416037861e-07,50
China,CHN,Summer,1992,366460.6923,1164970000.0,0.0003145666345914,16,22,16,54,48,44,16,108,0.0002947110079451,9.270624994635056e-08,54
China,CHN,Summer,1992,366460.6923,1164970000.0,0.0003145666345914,16,22,16,54,48,44,16,108,0.0002947110079451,9.270624994635056e-08,108
China,CHN,Winter,1992,366460.6923,1164970000.0,0.0003145666345914,0,3,0,3,0,6,0,6,1.637283377472897e-05,5.150347219241697e-09,111
China,CHN,Winter,1992,366460.6923,1164970000.0,0.0003145666345914,0,3,0,3,0,6,0,6,1.637283377472897e-05,5.150347219241697e-09,114
Colombia,COL,Summer,1992,1721291.68,33939039.0,0.0507171602590161,0,0,1,1,0,0,1,1,5.809590620922539e-07,2.9464593856060567e-08,1
Cuba,CUB,Summer,1992,2048068.839,10783748.0,0.1899218007505368,14,6,11,31,42,12,11,65,3.1737214473580495e-05,6.027588923628408e-06,31
Spain,ESP,Summer,1992,16112188.92,39157685.0,0.4114693940665798,13,7,2,22,39,14,2,55,3.413564741146295e-06,1.4045774156465072e-06,22
Spain,ESP,Summer,1992,16112188.92,39157685.0,0.4114693940665798,13,7,2,22,39,14,2,55,3.413564741146295e-06,1.4045774156465072e-06,44
Spain,ESP,Winter,1992,16112188.92,39157685.0,0.4114693940665798,0,0,1,1,0,0,1,1,6.206481347538717e-08,2.5537771193572863e-08,45
Spain,ESP,Winter,1992,16112188.92,39157685.0,0.4114693940665798,0,0,1,1,0,0,1,1,6.206481347538717e-08,2.5537771193572863e-08,46
Ethiopia,ETH,Summer,1992,201743.5026,52011554.0,0.0038788208981412,1,0,2,3,3,0,2,5,2.4783945631763804e-05,9.613248625488098e-08,3
Finland,FIN,Summer,1992,22319059.46,5041992.0,4.42663523861204,1,2,2,5,3,4,2,9,4.032427986551008e-07,1.7850087822432087e-06,5
Finland,FIN,Summer,1992,22319059.46,5041992.0,4.42663523861204,1,2,2,5,3,4,2,9,4.032427986551008e-07,1.7850087822432087e-06,10
Finland,FIN,Winter,1992,22319059.46,5041992.0,4.42663523861204,3,1,3,7,9,2,3,14,6.272665756857121e-07,2.77668032793388e-06,17
Finland,FIN,Winter,1992,22319059.46,5041992.0,4.42663523861204,3,1,3,7,9,2,3,14,6.272665756857121e-07,2.77668032793388e-06,24
France,FRA,Summer,1992,23814227.37,58849943.0,0.4046601603335453,8,5,16,29,24,10,16,50,2.0995852279040366e-06,8.496184949575907e-07,29
France,FRA,Summer,1992,23814227.37,58849943.0,0.4046601603335453,8,5,16,29,24,10,16,50,2.0995852279040366e-06,8.496184949575907e-07,58
France,FRA,Winter,1992,23814227.37,58849943.0,0.4046601603335453,3,5,1,9,9,10,1,20,8.398340911616147e-07,3.3984739798303626e-07,67
France,FRA,Winter,1992,23814227.37,58849943.0,0.4046601603335453,3,5,1,9,9,10,1,20,8.398340911616147e-07,3.3984739798303626e-07,76
United Kingdom,GBR,Summer,1992,20487170.79,57580402.0,0.3558011072934155,5,3,12,20,15,6,12,33,1.6107641381165058e-06,5.731116639303769e-07,20
Ghana,GHA,Summer,1992,394907.0373,16241548.0,0.0243146181201447,0,0,1,1,0,0,1,1,2.5322415291382297e-06,6.157048576896736e-08,1
Hungary,HUN,Summer,1992,3735105.82,10369341.0,0.3602066727287684,11,12,7,30,33,24,7,64,1.7134722035800312e-05,6.17204121264794e-06,30
Ireland,IRL,Summer,1992,15714384.75,3558430.0,4.416100569633237,1,1,0,2,3,2,0,5,3.181798129258608e-07,1.4051140531076909e-06,2
Italy,ITA,Summer,1992,23243474.53,56797087.0,0.4092370886908337,6,5,8,19,18,10,8,36,1.548821797426858e-06,6.338353232798717e-07,19
Italy,ITA,Summer,1992,23243474.53,56797087.0,0.4092370886908337,6,5,8,19,18,10,8,36,1.548821797426858e-06,6.338353232798717e-07,38
Italy,ITA,Winter,1992,23243474.53,56797087.0,0.4092370886908337,4,6,4,14,12,12,4,28,1.2046391757764452e-06,4.92983029217678e-07,52
Italy,ITA,Winter,1992,23243474.53,56797087.0,0.4092370886908337,4,6,4,14,12,12,4,28,1.2046391757764452e-06,4.92983029217678e-07,66
Jamaica,JAM,Summer,1992,1452188.387,2434574.0,0.596485622125267,0,3,1,4,0,6,1,7,4.8203112369332015e-06,2.875246346999516e-06,4
Japan,JPN,Summer,1992,31414984.64,124425000.0,0.2524812910588708,3,8,11,22,9,16,11,36,1.145949947534337e-06,2.8933092224231465e-07,22
Japan,JPN,Summer,1992,31414984.64,124425000.0,0.2524812910588708,3,8,11,22,9,16,11,36,1.145949947534337e-06,2.8933092224231465e-07,44
Japan,JPN,Winter,1992,31414984.64,124425000.0,0.2524812910588708,1,2,4,7,3,4,4,11,3.501513728577141e-07,8.84066706851517e-08,51
Japan,JPN,Winter,1992,31414984.64,124425000.0,0.2524812910588708,1,2,4,7,3,4,4,11,3.501513728577141e-07,8.84066706851517e-08,58
Kenya,KEN,Summer,1992,332950.2514,24655723.0,0.0135039743673304,2,4,2,8,6,8,2,16,4.805522726810591e-05,6.489365572447419e-07,8
"Korea, Rep.",KOR,Summer,1992,8126670.390000001,43747962.0,0.1857611193408278,12,5,12,29,36,10,12,58,7.136994269063741e-06,1.325776044150354e-06,29
"Korea, Rep.",KOR,Summer,1992,8126670.390000001,43747962.0,0.1857611193408278,12,5,12,29,36,10,12,58,7.136994269063741e-06,1.325776044150354e-06,58
"Korea, Rep.",KOR,Winter,1992,8126670.390000001,43747962.0,0.1857611193408278,2,1,1,4,6,2,1,9,1.1074646279581667e-06,2.0572386891988249e-07,62
"Korea, Rep.",KOR,Winter,1992,8126670.390000001,43747962.0,0.1857611193408278,2,1,1,4,6,2,1,9,1.1074646279581667e-06,2.0572386891988249e-07,66
Luxembourg,LUX,Winter,1992,39570861.57,392175.0,100.9010303308472,0,2,0,2,0,4,0,4,1.0108448088561544e-07,1.019952827181743e-05,2
Morocco,MAR,Summer,1992,1317329.956,25400676.0,0.0518620038301342,1,1,1,3,3,2,1,6,4.554667547543419e-06,2.3621418579568518e-07,3
Mexico,MEX,Summer,1992,4272785.965,84993164.0,0.0502721132372481,0,1,0,1,0,2,0,2,4.6807867662521684e-07,2.3531304235244146e-08,1
Namibia,NAM,Summer,1992,2346287.909,1461687.0,1.605191746933509,0,2,0,2,0,4,0,4,1.7048206167097458e-06,2.736563983944579e-06,2
Norway,NOR,Summer,1992,30523985.06,4286401.0,7.121122139529176,2,4,1,7,6,8,1,15,4.914168307485078e-07,3.4994392731804608e-06,7
Norway,NOR,Summer,1992,30523985.06,4286401.0,7.121122139529176,2,4,1,7,6,8,1,15,4.914168307485078e-07,3.4994392731804608e-06,14
Norway,NOR,Winter,1992,30523985.06,4286401.0,7.121122139529176,9,6,5,20,27,12,5,44,1.441489370195623e-06,1.0265021867996018e-05,34
Norway,NOR,Winter,1992,30523985.06,4286401.0,7.121122139529176,9,6,5,20,27,12,5,44,1.441489370195623e-06,1.0265021867996018e-05,54
New Zealand,NZL,Summer,1992,11793139.24,3531700.0,3.3392245207690348,1,4,5,10,3,8,5,16,1.3567210285901788e-06,4.530396126511312e-06,10
New Zealand,NZL,Summer,1992,11793139.24,3531700.0,3.3392245207690348,1,4,5,10,3,8,5,16,1.3567210285901788e-06,4.530396126511312e-06,20
New Zealand,NZL,Winter,1992,11793139.24,3531700.0,3.3392245207690348,0,1,0,1,0,2,0,2,1.6959012857377238e-07,5.66299515813914e-07,21
New Zealand,NZL,Winter,1992,11793139.24,3531700.0,3.3392245207690348,0,1,0,1,0,2,0,2,1.6959012857377238e-07,5.66299515813914e-07,22
Pakistan,PAK,Summer,1992,399465.0488,122375179.0,0.003264265286999,0,0,1,1,0,0,1,1,2.503347922437814e-06,8.171591724495047e-09,1
Peru,PER,Summer,1992,1560546.504,23047248.0,0.0677107524507915,0,1,0,1,0,2,0,2,1.2816023071876364e-06,8.677825656234533e-08,1
Poland,POL,Summer,1992,2459020.685,38363667.0,0.0640976443935873,3,6,10,19,9,12,10,31,1.2606644665130177e-05,8.080562267418285e-07,19
Qatar,QAT,Summer,1992,16223780.08,471293.0,34.42397845925995,0,0,1,1,0,0,1,1,6.163791638378766e-08,2.1218223058691728e-06,1
Romania,ROU,Summer,1992,1102103.785,22794284.0,0.0483500067385314,4,6,8,18,12,12,8,32,2.9035378006618495e-05,1.4038607222758126e-06,18
Suriname,SUR,Summer,1992,964433.2465,419521.0,2.2988914655047066,0,0,1,1,0,0,1,1,1.0368783984055657e-06,2.3836709008607435e-06,1
Sweden,SWE,Summer,1992,32800982.69,8668067.0,3.7841173458857664,1,7,4,12,3,14,4,21,6.402247212673372e-07,2.4226854730126105e-06,12
Sweden,SWE,Summer,1992,32800982.69,8668067.0,3.7841173458857664,1,7,4,12,3,14,4,21,6.402247212673372e-07,2.4226854730126105e-06,24
Sweden,SWE,Winter,1992,32800982.69,8668067.0,3.7841173458857664,1,0,3,4,3,0,3,6,1.829213489335249e-07,6.921958494321744e-07,28
Sweden,SWE,Winter,1992,32800982.69,8668067.0,3.7841173458857664,1,0,3,4,3,0,3,6,1.829213489335249e-07,6.921958494321744e-07,32
Thailand,THA,Summer,1992,1957407.581,56939020.0,0.0343772615159165,0,0,1,1,0,0,1,1,5.108798033208394e-07,1.7562648601960485e-08,1
Turkiye,TUR,Summer,1992,2814447.556,56302037.0,0.0499883788574114,2,2,2,6,6,4,2,12,4.263714196563271e-06,2.1313616059752865e-07,6
United States,USA,Summer,1992,25418990.78,256514000.0,0.0990939706214865,37,34,37,108,111,68,37,216,8.497583632232624e-06,8.420593028060846e-07,108
United States,USA,Summer,1992,25418990.78,256514000.0,0.0990939706214865,37,34,37,108,111,68,37,216,8.497583632232624e-06,8.420593028060846e-07,216
United States,USA,Winter,1992,25418990.78,256514000.0,0.0990939706214865,5,4,2,11,15,8,2,25,9.835166241009982e-07,9.746056745440794e-08,227
United States,USA,Winter,1992,25418990.78,256514000.0,0.0990939706214865,5,4,2,11,15,8,2,25,9.835166241009982e-07,9.746056745440794e-08,238
Australia,AUS,Winter,1994,18129790.720000003,17805468.0,1.018214782110754,0,0,1,1,0,0,1,1,5.5157834717686136e-08,5.6162522658769774e-08,1
Austria,AUT,Winter,1994,25646700.66,7936118.0,3.231643060246836,2,3,4,9,6,6,4,16,6.238619232981682e-07,2.016099054978769e-06,9
Belarus,BLR,Winter,1994,1460065.5,10226955.0,0.1427663952760132,0,2,0,2,0,4,0,4,2.7396031205449343e-06,3.9112326200711756e-07,2
Canada,CAN,Winter,1994,19935381.46,29000663.0,0.6874112312535752,3,6,4,13,9,12,4,25,1.254051749657365e-06,8.620492572876696e-07,13
China,CHN,Winter,1994,473492.2787,1191835000.0,0.000397280058649,0,1,2,3,0,2,2,4,8.447867430873906e-06,3.3561692683970516e-09,3
Finland,FIN,Winter,1994,20301333.09,5088333.0,3.989780757273551,0,1,5,6,0,2,5,7,3.448049430531264e-07,1.375696126806166e-06,6
France,FRA,Winter,1994,23496367.68,59327585.0,0.3960445664525195,0,1,4,5,0,2,4,6,2.553586189029197e-07,1.01133393513321e-07,5
United Kingdom,GBR,Winter,1994,19709238.1,57865745.0,0.3406028575282319,0,0,2,2,0,0,2,2,1.0147525692532988e-07,3.4562762477178856e-08,2
Italy,ITA,Winter,1994,19337630.9,56843400.0,0.3401913133274927,7,5,8,20,21,10,8,39,2.016793070551368e-06,6.860954833806563e-07,20
Japan,JPN,Winter,1994,39933515.06,125178000.0,0.3190138447650545,1,2,2,5,3,4,2,9,2.2537460041966067e-07,7.189761779226381e-08,5
Kazakhstan,KAZ,Winter,1994,1316183.6290000002,16145766.0,0.0815188098848949,1,2,0,3,3,4,0,7,5.318406828474539e-06,4.335501951409428e-07,3
"Korea, Rep.",KOR,Winter,1994,10385336.17,44641540.0,0.2326383939711757,4,1,1,6,12,2,1,15,1.4443441940117766e-06,3.36009913636492e-07,6
Norway,NOR,Winter,1994,29315841.91,4336613.0,6.760077947928487,10,11,5,26,30,22,5,57,1.944341225982549e-06,1.3143898245012871e-05,26
Russian Federation,RUS,Winter,1994,2662104.004,148407912.0,0.0179377498687536,11,8,4,23,33,16,4,53,1.990906437928937e-05,3.571238169566054e-07,23
Sweden,SWE,Winter,1994,26083614.39,8780745.0,2.97054684881522,2,1,0,3,6,2,0,8,3.0670596031610786e-07,9.110844239298602e-07,3
Ukraine,UKR,Winter,1994,1011979.37,51921400.0,0.019490602526126,1,0,1,2,3,0,1,4,3.952649746209747e-06,7.70395251283671e-08,2
United States,USA,Winter,1994,27694853.42,263126000.0,0.1052531996838016,6,5,2,13,18,10,2,30,1.083233752677504e-06,1.1401381847479918e-07,13
Uzbekistan,UZB,Winter,1994,576447.1105,22377000.0,0.0257606967198462,1,0,0,1,3,0,0,3,5.204293586271694e-06,1.340662287169862e-07,1
Argentina,ARG,Summer,1996,7690157.003,35389362.0,0.2173013744356284,0,2,1,3,0,4,1,5,6.501817840714376e-07,1.412853953117324e-07,3
Armenia,ARM,Summer,1996,484091.641,3298898.0,0.1467434400821122,1,1,0,2,3,2,0,5,1.0328622881550644e-05,1.5156576529495606e-06,2
Australia,AUS,Summer,1996,22020093.720000003,18224767.0,1.208251042112089,9,9,23,41,27,18,23,68,3.088088582395006e-06,3.73118624781321e-06,41
Austria,AUT,Summer,1996,29809076.77,7959017.0,3.745321409666545,0,1,2,3,0,2,2,4,1.3418731585896077e-07,5.02574626992253e-07,3
Azerbaijan,AZE,Summer,1996,409163.1891,7763000.0,0.0527068387350251,0,1,0,1,0,2,0,2,4.888025250754406e-06,2.576323586242432e-07,1
Burundi,BDI,Summer,1996,146536.1825,5930507.0,0.0247088794431909,1,0,0,1,3,0,0,3,2.0472759347337305e-05,5.05858942582818e-07,1
Belgium,BEL,Summer,1996,27489555.18,10156637.0,2.7065607621892958,2,2,2,6,6,4,2,12,4.3652943532278723e-07,1.1814934411853057e-06,6
Belarus,BLR,Summer,1996,1452507.105,10159569.0,0.1429693626767041,1,6,8,15,3,12,8,23,1.5834690185560228e-05,2.263875564012607e-06,15
Brazil,BRA,Summer,1996,5121905.407000001,166037122.0,0.0308479534293541,3,3,9,15,9,6,9,24,4.685756196746567e-06,1.4454598893854592e-07,15
Canada,CAN,Summer,1996,21227347.53,29610218.0,0.7168926459778174,3,11,8,22,9,22,8,39,1.8372526263529828e-06,1.3171128966358842e-06,22
China,CHN,Summer,1996,709413.7551,1217550000.0,0.0005826567739312,16,22,12,50,48,44,12,104,0.00014659992036,8.541743665557884e-08,50
Cuba,CUB,Summer,1996,2281975.5500000003,10963031.0,0.2081518833614536,9,8,8,25,27,16,8,51,2.234905628151888e-05,4.651998156349279e-06,25
Czechia,CZE,Summer,1996,6532837.055,10315241.0,0.6333188972511645,4,3,4,11,12,6,4,22,3.3676027451445443e-06,2.132766456934937e-06,11
Ecuador,ECU,Summer,1996,2142328.641,11775221.0,0.1819353234219553,1,0,0,1,3,0,0,3,1.4003453730608086e-06,2.5477228835025684e-07,1
Spain,ESP,Summer,1996,16109084.4,39889852.0,0.4038391619001243,5,6,6,17,15,12,6,33,2.0485335591140117e-06,8.272780756368813e-07,17
Ethiopia,ETH,Summer,1996,144031.64870000002,59347649.0,0.0024269141427994,2,0,1,3,6,0,1,7,4.860042958044678e-05,1.17949069894917e-07,3
Finland,FIN,Summer,1996,25783450.49,5124573.0,5.0313363650005565,1,2,1,4,3,4,1,8,3.102765474738444e-07,1.561105676511975e-06,4
France,FRA,Summer,1996,26870285.24,59756533.0,0.4496627212291583,15,7,15,37,45,14,15,74,2.753971509384692e-06,1.238358323097493e-06,37
United Kingdom,GBR,Summer,1996,24440328.14,58166950.0,0.4201755144459181,1,8,6,15,3,16,6,25,1.0228995231485463e-06,4.297973333654249e-07,15
Georgia,GEO,Summer,1996,689059.4414,4491699.0,0.1534073056542747,0,0,2,2,0,0,2,2,2.9025072146700288e-06,4.452658114446226e-07,2
"Hong Kong SAR, China",HKG,Summer,1996,24818154.55,6435500.0,3.856445427705695,1,0,0,1,3,0,0,3,1.2087925369132653e-07,4.66164245202393e-07,1
Hungary,HUN,Summer,1996,4525039.103,10311238.0,0.4388453746291182,7,4,10,21,21,8,10,39,8.618710051399084e-06,3.7822810413259776e-06,21
India,IND,Summer,1996,399577.5035,983281218.0,0.0004063715406999,0,0,1,1,0,0,1,1,2.502643395188038e-06,1.0170030523251586e-09,1
Ireland,IRL,Summer,1996,20835897.71,3637510.0,5.728066097412791,3,0,1,4,9,0,1,10,4.799409240332655e-07,2.749133335715916e-06,4
Israel,ISR,Summer,1996,20116981.87,5692000.0,3.534255423401265,0,0,1,1,0,0,1,1,4.970924597249239e-08,1.7568517217146873e-07,1
Italy,ITA,Summer,1996,23081604.68,56860281.0,0.405935466270383,13,10,12,35,39,20,12,71,3.076042631538562e-06,1.2486747999011822e-06,35
Jamaica,JAM,Summer,1996,2919144.486,2532894.0,1.1524937427306472,1,3,2,6,3,6,2,11,3.768227318913189e-06,4.342858406234134e-06,6
Japan,JPN,Summer,1996,39150039.63,125757000.0,0.311314993439729,3,6,5,14,9,12,5,26,6.641117159962373e-07,2.0674793450861585e-07,14
Kazakhstan,KAZ,Summer,1996,1350305.67,15578227.0,0.0866790341416901,3,4,4,11,9,8,4,21,1.555203422940526e-05,1.3480353059433528e-06,11
Kenya,KEN,Summer,1996,436195.4516,27615736.0,0.0157951774886608,1,4,3,8,3,8,3,14,3.209570376914035e-05,5.069573376570517e-07,8
"Korea, Rep.",KOR,Summer,1996,13403049.59,45524681.0,0.2944128173023332,7,15,5,27,21,30,5,56,4.178153607801432e-06,1.2301019747947272e-06,27
Lithuania,LTU,Summer,1996,2327434.8570000003,3601613.0,0.6462201399761719,0,0,1,1,0,0,1,1,4.296575678551848e-07,2.776533736411991e-07,1
Morocco,MAR,Summer,1996,1585718.384,26999093.0,0.0587322834881897,0,0,2,2,0,0,2,2,1.2612580015342748e-06,7.407656249785872e-08,2
Moldova,MDA,Summer,1996,575145.4551,2947293.0,0.1951436301378926,0,1,1,2,0,2,1,3,5.216071818699137e-06,1.0178831897609091e-06,2
Mexico,MEX,Summer,1996,4487291.779,91586555.0,0.0489950929915422,0,0,1,1,0,0,1,1,2.2285156598906333e-07,1.0918633198944976e-08,1
Mozambique,MOZ,Summer,1996,239857.4043,16079553.0,0.0149169199106467,0,0,1,1,0,0,1,1,4.169143758219183e-06,6.219078353732845e-08,1
Namibia,NAM,Summer,1996,2417605.515,1650066.0,1.4651568573620692,0,2,0,2,0,4,0,4,1.6545296472820131e-06,2.424145458424087e-06,2
Norway,NOR,Summer,1996,37321974.2,4381336.0,8.518400369202451,2,2,3,7,6,4,3,13,3.483202665093746e-07,2.967131486834153e-06,7
New Zealand,NZL,Summer,1996,18794436.04,3732000.0,5.036022518756699,3,2,1,6,9,4,1,14,7.449013085683417e-07,3.751339764201501e-06,6
Poland,POL,Summer,1996,4147465.501,38624370.0,0.107379499031311,7,5,5,17,21,10,5,36,8.679999867707159e-06,9.320540373862408e-07,17
Romania,ROU,Summer,1996,1633010.644,22619004.0,0.0721963992755825,4,7,9,20,12,14,9,35,2.1432805798662022e-05,1.5473714050362252e-06,20
Russian Federation,RUS,Summer,1996,2643929.199,148160129.0,0.0178450789483316,26,21,16,63,78,42,16,136,5.143859376092166e-05,9.179257666548065e-07,63
Slovak Republic,SVK,Summer,1996,5196940.38,5373361.0,0.9671675474623797,1,1,1,3,3,2,1,6,1.1545254633073163e-06,1.1166195608298046e-06,3
Sweden,SWE,Summer,1996,32998968.16,8840998.0,3.7324935669027406,2,4,2,8,6,8,2,16,4.848636455061812e-07,1.8097504376768324e-06,8
Syrian Arab Republic,SYR,Summer,1996,4184294.44,14708879.0,0.2844740540730534,1,0,0,1,3,0,0,3,7.169667534199626e-07,2.0395843898097202e-07,1
Thailand,THA,Summer,1996,3039890.1,60211096.0,0.0504872075406167,1,0,1,2,3,0,1,4,1.3158370429246767e-06,6.64329378757696e-08,2
Trinidad and Tobago,TTO,Summer,1996,4385098.699999999,1313434.0,3.3386517327859635,0,0,2,2,0,0,2,2,4.5609007614811516e-07,1.5227259230383864e-06,2
Tunisia,TUN,Summer,1996,2077007.469,9430550.0,0.2202424534093982,0,0,1,1,0,0,1,1,4.814619181323705e-07,1.060383540726681e-07,1
Turkiye,TUR,Summer,1996,3009855.034,60293786.0,0.0499198214887351,4,1,1,6,12,2,1,15,4.983628723163284e-06,2.487818562264443e-07,6
Uganda,UGA,Summer,1996,284456.8035,21249572.0,0.0133864721369446,0,0,1,1,0,0,1,1,3.515472253417205e-06,4.7059771368571566e-08,1
Ukraine,UKR,Summer,1996,872698.7305000001,51057800.0,0.0170923684628009,9,2,12,23,27,4,12,43,4.927244477067565e-05,8.421827810833996e-07,23
United States,USA,Summer,1996,29967712.72,269394000.0,0.1112412032933175,44,32,25,101,132,64,25,221,7.37460352963501e-06,8.203597704477457e-07,101
Uzbekistan,UZB,Summer,1996,600598.1577999999,23225000.0,0.0258599852658772,0,1,1,2,0,2,1,3,4.995020316061317e-06,1.2917115177610334e-07,2
Australia,AUS,Winter,1998,21478385.16,18607584.0,1.154281241455097,0,0,1,1,0,0,1,1,4.655843502901408e-08,5.374152818549684e-08,1
Austria,AUT,Winter,1998,27361875.11,7976789.0,3.4301866465315807,3,5,9,17,9,10,9,28,1.023321679798428e-06,3.510184361150834e-06,17
Belgium,BEL,Winter,1998,25338443.29,10203008.0,2.4834287388581875,0,0,1,1,0,0,1,1,3.946572362614941e-08,9.801031225301403e-08,1
Belarus,BLR,Winter,1998,1511325.316,10071963.0,0.1500527073024394,0,0,2,2,0,0,2,2,1.3233418237797852e-06,1.985710233447045e-07,2
Canada,CAN,Winter,1998,21024585.07,30155173.0,0.6972132134675533,6,5,4,15,18,10,4,32,1.5220276592122062e-06,1.0611777952658404e-06,15
China,CHN,Winter,1998,828580.4793,1241935000.0,0.0006671689575541,0,6,2,8,0,12,2,14,1.6896367160167055e-05,1.1272731664700648e-08,8
Czechia,CZE,Winter,1998,6489703.619,10294373.0,0.6304127137223413,1,1,1,3,3,2,1,6,9.24541450927545e-07,5.828426850280245e-07,3
Finland,FIN,Winter,1998,26009269.49,5153498.0,5.046915607612537,2,4,6,12,6,8,6,20,7.689566217032573e-07,3.880859175651179e-06,12
France,FRA,Winter,1998,24971574.49,60192790.0,0.4148598941833398,2,1,5,8,6,2,5,13,5.205919236372508e-07,2.1597271035285122e-07,8
United Kingdom,GBR,Winter,1998,28297866.0,58487141.0,0.4838305568740315,0,0,1,1,0,0,1,1,3.533835378257852e-08,1.7097775389636502e-08,1
Italy,ITA,Winter,1998,22318137.3,56906744.0,0.392187915372561,2,6,2,10,6,12,2,20,8.961321337511443e-07,3.514521934342264e-07,10
Japan,JPN,Winter,1998,32423755.61,126400000.0,0.2565170538765822,5,1,4,10,15,2,4,21,6.476732755018444e-07,1.661392405063291e-07,10
Kazakhstan,KAZ,Winter,1998,1468669.291,15071640.0,0.0974458845221886,0,0,2,2,0,0,2,2,1.36177695840445e-06,1.3269956023365738e-07,2
"Korea, Rep.",KOR,Winter,1998,8281699.982,46286503.0,0.1789225680324132,3,1,2,6,9,2,2,13,1.5697260258467547e-06,2.8085941165181565e-07,6
Norway,NOR,Winter,1998,34788359.85,4431464.0,7.850308577481392,10,10,5,25,30,20,5,55,1.5809885903545982e-06,1.2411248291760916e-05,25
Russian Federation,RUS,Winter,1998,1834861.816,147670784.0,0.0124253543341382,9,6,3,18,27,12,3,42,2.2890007102311404e-05,2.8441644895716135e-07,18
Sweden,SWE,Winter,1998,30596527.2,8850974.0,3.4568542625930205,0,2,1,3,0,4,1,5,1.634172390649616e-07,5.649095794428952e-07,3
Ukraine,UKR,Winter,1998,835250.9765999999,50144500.0,0.0166568811454895,0,1,0,1,0,2,0,2,2.3944898671549785e-06,3.98847331212795e-08,1
United States,USA,Winter,1998,32853676.95,275854000.0,0.1190980625620799,6,3,4,13,18,6,4,28,8.522638133507306e-07,1.0150296896184213e-07,13
Argentina,ARG,Summer,2000,7666517.834,37070774.0,0.2068076008879663,0,2,2,4,0,4,2,6,7.826238886956981e-07,1.6185256881876813e-07,4
Armenia,ARM,Summer,2000,603298.0252,3168523.0,0.1904035492877911,0,0,1,1,0,0,1,1,1.6575555666181549e-06,3.1560446302583253e-07,1
Australia,AUS,Summer,2000,21853781.67,19028802.0,1.1484580936834594,16,25,17,58,48,50,17,115,5.262247135829466e-06,6.043470314105954e-06,58
Austria,AUT,Summer,2000,24625600.72,8011566.0,3.073756206963782,2,1,0,3,6,2,0,8,3.248651714515414e-07,9.985563371755285e-07,3
Azerbaijan,AZE,Summer,2000,655119.9452,8048600.0,0.0813955153939815,2,0,1,3,6,0,1,7,1.068506622533525e-05,8.697164724299879e-07,3
Belgium,BEL,Summer,2000,23098886.51,10251250.0,2.253275113766614,0,2,3,5,0,4,3,7,3.030449107133173e-07,6.828435556639435e-07,5
Belarus,BLR,Summer,2000,1276288.034,9979610.0,0.1278895702337065,3,3,11,17,9,6,11,26,2.037157703227358e-05,2.6053122316403144e-06,17
Brazil,BRA,Summer,2000,3726811.42,175873720.0,0.0211902689043024,0,6,6,12,0,12,6,18,4.829866062823216e-06,1.0234616064298863e-07,12
Canada,CAN,Summer,2000,24271002.06,30685730.0,0.7909540382451387,3,3,8,14,9,6,8,23,9.476328971973232e-07,7.495340668121631e-07,14
Channel Islands,CHI,Summer,2000,44316153.59,145306.0,304.9850218848499,0,0,1,1,0,0,1,1,2.2565135260873615e-08,6.882028271372139e-06,1
China,CHN,Summer,2000,959372.4836,1262645000.0,0.0007598117314051,28,16,14,58,84,32,14,130,0.0001355052414179,1.0295847209627409e-07,58
Cameroon,CMR,Summer,2000,700163.2135999999,15091594.0,0.0463942518994348,1,0,0,1,3,0,0,3,4.284715251712562e-06,1.987861587053031e-07,1
Colombia,COL,Summer,2000,2547143.528,39215135.0,0.0649530730418242,1,0,0,1,3,0,0,3,1.1777899309645813e-06,7.650107541386764e-08,1
Cuba,CUB,Summer,2000,2752203.783,11105791.0,0.2478169977266815,11,11,7,29,33,22,7,62,2.252740163463397e-05,5.582673039678128e-06,29
Czechia,CZE,Summer,2000,6029038.193,10255063.0,0.5879084500017211,2,3,3,8,6,6,3,15,2.4879590275967587e-06,1.4626921355821998e-06,8
Spain,ESP,Summer,2000,14749687.42,40567864.0,0.3635805774738349,3,3,5,11,9,6,5,20,1.355960938730185e-06,4.93001061135484e-07,11
Estonia,EST,Summer,2000,4070609.024,1396985.0,2.9138530649935395,1,0,2,3,3,0,2,5,1.228317426340968e-06,3.579136497528606e-06,3
Ethiopia,ETH,Summer,2000,122962.2935,67031867.0,0.0018343856288532,4,1,3,8,12,2,3,17,0.0001382537647608,2.536107192121025e-07,8
Finland,FIN,Summer,2000,24345914.82,5176209.0,4.703425773572898,2,1,1,4,6,2,1,9,3.696718758173984e-07,1.7387242284845918e-06,4
France,FRA,Summer,2000,22416425.42,60921384.0,0.3679566015768781,13,14,11,38,39,28,11,78,3.479591350475004e-06,1.2803386081970822e-06,38
United Kingdom,GBR,Summer,2000,28290972.5,58892514.0,0.4803831689032667,11,10,7,28,33,20,7,60,2.1208178686681765e-06,1.0188052084174908e-06,28
Georgia,GEO,Summer,2000,749908.535,4077131.0,0.1839304488867294,0,0,6,6,0,0,6,6,8.000975745662102e-06,1.4716230604314653e-06,6
Hungary,HUN,Summer,2000,4624281.657000001,10210971.0,0.4528738409892654,8,6,3,17,24,12,3,39,8.433742339410446e-06,3.8194212871626016e-06,17
India,IND,Summer,2000,442034.7789,1059633675.0,0.0004171581078715,0,0,1,1,0,0,1,1,2.2622654318931467e-06,9.43722367071809e-10,1
Ireland,IRL,Summer,2000,26334567.21,3805174.0,6.920726150762095,0,1,0,1,0,2,0,2,7.594580856603338e-08,5.256001433837191e-07,1
Iceland,ISL,Summer,2000,32096372.26,281205.0,114.13869689372522,0,0,1,1,0,0,1,1,3.11561690492432e-08,3.5561245354812328e-06,1
Israel,ISR,Summer,2000,21630747.61,6289000.0,3.4394574034027667,0,0,1,1,0,0,1,1,4.623048717639769e-08,1.590077913817777e-07,1
Italy,ITA,Summer,2000,20137591.22,56942108.0,0.3536502586100254,13,8,13,34,39,16,13,68,3.376769309552009e-06,1.1941953395894651e-06,34
Jamaica,JAM,Summer,2000,3447303.896,2612205.0,1.3196911789082402,0,6,3,9,0,12,3,15,4.351226480904369e-06,5.7422752042814406e-06,9
Japan,JPN,Summer,2000,39169359.57,126843000.0,0.3088019013268371,5,8,5,18,15,16,5,36,9.19085744449408e-07,2.838154253683688e-07,18
Kazakhstan,KAZ,Summer,2000,1229001.247,14883626.0,0.082574047950412,3,4,0,7,9,8,0,17,1.3832370017115208e-05,1.1421947850611135e-06,7
Kenya,KEN,Summer,2000,411821.5792,30851606.0,0.013348464880564,2,3,2,7,6,6,2,14,3.399530453745587e-05,4.5378512872231036e-07,7
Kyrgyz Republic,KGZ,Summer,2000,279619.56930000003,4898400.0,0.0570838578515433,0,0,1,1,0,0,1,1,3.5762876057044263e-06,2.0414829332026786e-07,1
"Korea, Rep.",KOR,Summer,2000,12256993.57,47008111.0,0.2607420998048613,8,10,10,28,24,20,10,54,4.405648064642005e-06,1.14873792737598e-06,28
Lithuania,LTU,Summer,2000,3293229.9790000003,3499536.0,0.9410476071684932,2,0,3,5,6,0,3,9,2.732879287930228e-06,2.5717695145870767e-06,5
Morocco,MAR,Summer,2000,1348049.8050000002,28554415.0,0.0472098554636822,0,1,4,5,0,2,4,6,4.450874127755242e-06,2.1012512425836774e-07,5
Moldova,MDA,Summer,2000,440538.684,2924668.0,0.1506286128887108,0,1,1,2,0,2,1,3,6.8098446491931685e-06,1.0257574534955762e-06,2
Mexico,MEX,Summer,2000,7232878.808999999,97873442.0,0.0739003212842969,1,2,3,6,3,4,3,10,1.3825753567938707e-06,1.0217276306681848e-07,6
North Macedonia,MKD,Summer,2000,1861898.065,2026350.0,0.9188432723863104,0,0,1,1,0,0,1,1,5.370863307707449e-07,4.934981617193476e-07,1
Mozambique,MOZ,Summer,2000,318342.6885,17768505.0,0.0179161211649488,1,0,0,1,3,0,0,3,9.423806823193302e-06,1.688380648794032e-07,1
Norway,NOR,Summer,2000,38131460.61,4490967.0,8.490701581641549,4,3,3,10,12,6,3,21,5.507263468027956e-07,4.676053063850168e-06,10
New Zealand,NZL,Summer,2000,13641102.72,3857700.0,3.5360714207947743,1,0,3,4,3,0,3,6,4.3984713869231836e-07,1.555330896648262e-06,4
Poland,POL,Summer,2000,4501454.067,38258629.0,0.1176585304977865,6,5,3,14,18,10,3,31,6.886663628817164e-06,8.102747225991815e-07,14
Qatar,QAT,Summer,2000,27494771.33,645937.0,42.56571667205935,0,0,1,1,0,0,1,1,3.637055162226003e-08,1.548138595559629e-06,1
Romania,ROU,Summer,2000,1659907.64,22442971.0,0.0739611364288622,11,6,9,26,33,12,9,54,3.2531930511507254e-05,2.406098550855856e-06,26
Russian Federation,RUS,Summer,2000,1771594.116,146596869.0,0.0120848018657206,32,28,29,89,96,56,29,181,0.0001021678715035,1.23467848416326e-06,89
Slovak Republic,SVK,Summer,2000,5426624.281,5388720.0,1.0070340045502455,1,3,1,5,3,6,1,10,1.842766235910704e-06,1.8557282619991389e-06,5
Sweden,SWE,Summer,2000,29624912.67,8872109.0,3.3391060310462826,4,5,3,12,12,10,3,25,8.43884344182946e-07,2.817819303166812e-06,12
Thailand,THA,Summer,2000,2004107.209,63066603.0,0.0317776305313289,1,0,2,3,3,0,2,5,2.494876510371357e-06,7.928126396787218e-08,3
Trinidad and Tobago,TTO,Summer,2000,6120942.704,1332203.0,4.594602101931913,0,1,1,2,0,2,1,3,4.901205819227025e-07,2.251909055902141e-06,2
Turkiye,TUR,Summer,2000,4278393.130000001,64113547.0,0.0667314995066487,3,0,2,5,9,0,2,11,2.5710587283034454e-06,1.715706042593463e-07,5
Ukraine,UKR,Summer,2000,658348.6328,49176500.0,0.0133874641912295,3,10,10,23,9,20,10,39,5.923912962973802e-05,7.930617266377233e-07,23
United States,USA,Summer,2000,36329956.07,282162411.0,0.1287554778868118,37,24,32,93,111,48,32,191,5.2573694180082176e-06,6.769151118431576e-07,93
Uzbekistan,UZB,Summer,2000,558226.8024,24650400.0,0.0226457502677441,1,1,2,4,3,2,2,7,1.2539706029708184e-05,2.839710511796969e-07,4
Australia,AUS,Winter,2002,20291178.55,19495210.0,1.0408289292600592,2,0,0,2,6,0,0,6,2.9569499796255055e-07,3.077679081169169e-07,2
Austria,AUT,Winter,2002,26527593.09,8081957.0,3.282322968310769,3,3,10,16,9,6,10,25,9.42414938105491e-07,3.093310197022825e-06,16
Belarus,BLR,Winter,2002,1479314.583,9865548.0,0.1499475328689293,0,0,1,1,0,0,1,1,6.759887393065738e-07,1.0136284370619858e-07,1
Canada,CAN,Winter,2002,24255338.58,31360079.0,0.7734463481421714,7,3,7,17,21,6,7,34,1.4017532630129956e-06,1.0841809422737742e-06,17
China,CHN,Winter,2002,1148508.29,1280400000.0,0.0008969917916276,2,2,4,8,6,4,4,14,1.2189724812521817e-05,1.0934083099031552e-08,8
Czechia,CZE,Winter,2002,8060868.703,10196916.0,0.7905202615182865,1,2,0,3,3,4,0,7,8.68392757395344e-07,6.864820696767533e-07,3
Estonia,EST,Winter,2002,5341628.947,1379350.0,3.8725696501975566,1,1,1,3,3,2,1,6,1.1232528615395046e-06,4.349874941095444e-06,3
Finland,FIN,Winter,2002,26997752.99,5200598.0,5.191278577963534,4,2,1,7,12,4,1,17,6.296820334009582e-07,3.268854850922913e-06,7
France,FRA,Winter,2002,24288270.02,61816234.0,0.3929108657767796,4,5,2,11,12,10,2,24,9.881313070151713e-07,3.882475273404718e-07,11
United Kingdom,GBR,Winter,2002,30079660.04,59370479.0,0.5066433781004193,1,0,0,1,3,0,0,3,9.97351697462868e-08,5.0530163315677485e-08,1
Italy,ITA,Winter,2002,22376297.9,57059007.0,0.3921606609803076,4,4,5,13,12,8,5,25,1.1172536275538233e-06,4.381429210641538e-07,13
Japan,JPN,Winter,2002,32820793.640000004,127445000.0,0.257529080309153,0,1,1,2,0,2,1,3,9.140546791482157e-08,2.3539566087331792e-08,2
"Korea, Rep.",KOR,Winter,2002,13165065.74,47644736.0,0.2763173195040896,2,2,0,4,6,4,0,10,7.59586028470527e-07,2.098867753197331e-07,4
Norway,NOR,Winter,2002,43084472.47,4538159.0,9.493821717132432,13,5,7,25,39,10,7,56,1.2997722100228375e-06,1.233980563484003e-05,25
Poland,POL,Winter,2002,5207171.421,38230364.0,0.1362051227396108,0,1,1,2,0,2,1,3,5.76128526881466e-07,7.847165671768126e-08,2
Russian Federation,RUS,Winter,2002,2377529.541,145306497.0,0.0163621695525424,5,4,4,13,15,8,4,27,1.1356325771937066e-05,1.858141277743417e-07,13
Sweden,SWE,Winter,2002,29899195.25,8924958.0,3.35006565297002,0,2,5,7,0,4,5,9,3.010114461191059e-07,1.0084081067944522e-06,7
United States,USA,Winter,2002,37997759.66,287625193.0,0.1321085933525997,8,12,11,31,24,24,11,59,1.5527231217820696e-06,2.0512806748468659e-07,31
Argentina,ARG,Summer,2004,4258160.261,38668796.0,0.1101187702094474,2,0,4,6,6,0,4,10,2.348432042727196e-06,2.586064484655793e-07,6
Australia,AUS,Summer,2004,30819993.49,19932722.0,1.546200939841533,17,16,17,50,51,32,17,100,3.244647018905e-06,5.016876270084939e-06,50
Austria,AUT,Summer,2004,36889233.51,8171966.0,4.514119798099991,2,4,1,7,6,8,1,15,4.0662270729842553e-07,1.8355436133728408e-06,7
Azerbaijan,AZE,Summer,2004,1045009.379,8306500.0,0.1258062215132727,1,0,4,5,3,0,4,7,6.69850447342253e-06,8.427135375910432e-07,5
Belgium,BEL,Summer,2004,35429407.79,10421137.0,3.399764132263111,1,0,2,3,3,0,2,5,1.4112570070706225e-07,4.79794095404369e-07,3
Belarus,BLR,Summer,2004,2378623.286,9730146.0,0.2444591567279668,2,5,6,13,6,10,6,22,9.249047602235571e-06,2.2610143773793323e-06,13
Brazil,BRA,Summer,2004,3623247.996,184722043.0,0.0196145946480247,5,2,3,10,15,4,3,22,6.071900136089939e-06,1.1909785991269056e-07,10
Canada,CAN,Summer,2004,32143681.41,31940655.0,1.0063563633870376,3,6,3,12,9,12,3,24,7.466475197372236e-07,7.513934826947037e-07,12
Channel Islands,CHI,Summer,2004,57202561.03,149538.0,382.52859493907897,2,0,1,3,6,0,1,7,1.2237214337883993e-07,4.681084406639115e-05,3
China,CHN,Summer,2004,1508668.098,1296075000.0,0.0011640283918754,32,17,14,63,96,34,14,144,9.544842910836178e-05,1.1110468144204619e-07,63
Cameroon,CMR,Summer,2004,1119980.93,16809407.0,0.066628223708308,1,0,0,1,3,0,0,3,2.678617036809725e-06,1.7847149515744368e-07,1
Colombia,COL,Summer,2004,2811197.871,41648268.0,0.0674985541055392,0,0,2,2,0,0,2,2,7.11440493261529e-07,4.802120462728486e-08,2
Cuba,CUB,Summer,2004,3403296.163,11225294.0,0.3031810269735474,9,7,11,27,27,14,11,52,1.527930497655017e-05,4.632395374232514e-06,27
Czechia,CZE,Summer,2004,11749852.66,10197101.0,1.1522738335140543,1,3,5,9,3,6,5,14,1.19150430265906e-06,1.3729392304734453e-06,9
Dominican Republic,DOM,Summer,2004,2468437.673,9043127.0,0.2729628449318471,1,0,0,1,3,0,0,3,1.2153436292170863e-06,3.31743654600892e-07,1
"Egypt, Arab Rep.",EGY,Summer,2004,1016253.884,77522427.0,0.0131091598048136,1,1,3,5,3,2,3,8,7.87204863465004e-06,1.0319594354289245e-07,5
Eritrea,ERI,Summer,2004,401374.5252,2763140.0,0.145260292710467,0,0,1,1,0,0,1,1,2.491438637022896e-06,3.61907105684113e-07,1
Spain,ESP,Summer,2004,24907000.85,42921895.0,0.5802866078023815,3,11,6,20,9,22,6,37,1.4855261066086966e-06,8.620309052058395e-07,20
Estonia,EST,Summer,2004,8914103.557,1362550.0,6.542221244724964,0,1,2,3,0,2,2,4,4.487271181473891e-07,2.935672085428058e-06,3
Ethiopia,ETH,Summer,2004,134542.48630000002,75301026.0,0.0017867284610438,2,3,2,7,6,6,2,14,0.0001040563496707,1.8592044150899088e-07,7
Finland,FIN,Summer,2004,37772178.11,5228172.0,7.224738992902299,0,2,0,2,0,4,0,4,1.0589804983846085e-07,7.650857699402391e-07,2
France,FRA,Summer,2004,33797162.44,62716306.0,0.5388895583231575,11,9,13,33,33,18,13,64,1.8936500989874227e-06,1.0204682654619358e-06,33
United Kingdom,GBR,Summer,2004,40390785.83,59987905.0,0.6733154930148002,9,9,12,30,27,18,12,57,1.411212949406486e-06,9.501915427784984e-07,30
Georgia,GEO,Summer,2004,1305047.486,3927340.0,0.3322980658664643,2,2,0,4,6,4,0,10,7.662556425935293e-06,2.5462526799309456e-06,4
"Hong Kong SAR, China",HKG,Summer,2004,24928100.37,6783500.0,3.6748139411808074,0,1,0,1,0,2,0,2,8.02307424278074e-08,2.9483305078499297e-07,1
Hungary,HUN,Summer,2004,10301703.39,10107146.0,1.0192494884312546,8,6,3,17,24,12,3,39,3.785781683236756e-06,3.858656043951477e-06,17
India,IND,Summer,2004,624105.0944,1136264583.0,0.0005492603604278,0,1,0,1,0,2,0,2,3.204588486691898e-06,1.7601534272233844e-09,1
Israel,ISR,Summer,2004,20557078.63,6809000.0,3.0191039256865912,1,0,1,2,3,0,1,4,1.9458017707645456e-07,5.874577764723161e-07,2
Italy,ITA,Summer,2004,31317200.79,57685327.0,0.5428971701937305,10,11,11,32,30,22,11,63,2.0116740452779144e-06,1.0921321465335543e-06,32
Jamaica,JAM,Summer,2004,3819284.231,2664024.0,1.4336523360900653,2,1,2,5,6,2,2,10,2.6182916471188394e-06,3.753719936457029e-06,5
Japan,JPN,Summer,2004,38298980.17,127761000.0,0.2997705103278778,16,9,12,37,48,18,12,78,2.0366077544043385e-06,6.10514945875502e-07,37
Kazakhstan,KAZ,Summer,2004,2874288.483,15012984.0,0.1914535100417079,1,4,3,8,3,8,3,14,4.870770656043435e-06,9.32526138707668e-07,8
Kenya,KEN,Summer,2004,462618.2158,34791836.0,0.0132967462769139,1,4,2,7,3,8,2,13,2.810092546295277e-05,3.736508760273531e-07,7
"Korea, Rep.",KOR,Summer,2004,16496120.09,48082519.0,0.3430793650806855,9,12,9,30,27,24,9,60,3.63721891406284e-06,1.2478547556961398e-06,30
Lithuania,LTU,Summer,2004,6700327.192,3377075.0,1.9840623000673656,1,2,0,3,3,4,0,7,1.044725100642518e-06,2.072799686118905e-06,3
Morocco,MAR,Summer,2004,1964080.078,30033125.0,0.0653971266060391,2,1,0,3,6,2,0,8,4.0731536812624805e-06,2.663725469793769e-07,3
Mexico,MEX,Summer,2004,7525465.234,103945813.0,0.0723979640622946,0,3,1,4,0,6,1,7,9.301750499589112e-07,6.734277983856839e-08,4
Norway,NOR,Summer,2004,57603836.02,4591910.0,12.544635243286564,5,0,1,6,15,0,1,16,2.777592796848601e-07,3.4843888490845857e-06,6
New Zealand,NZL,Summer,2004,25420234.88,4087500.0,6.21901770764526,3,2,0,5,9,4,0,13,5.114036145365467e-07,3.180428134556575e-06,5
Poland,POL,Summer,2004,6681386.472,38182222.0,0.1749868426201073,3,2,5,10,9,4,5,18,2.694051612705453e-06,4.7142358556293566e-07,10
Romania,ROU,Summer,2004,3494944.517,21451748.0,0.1629211995684454,8,5,6,19,24,10,6,40,1.1445103006766846e-05,1.864649911046876e-06,19
Russian Federation,RUS,Summer,2004,4102364.746,144067316.0,0.0284753326424155,28,26,36,90,84,52,36,172,4.192703736733993e-05,1.1938863357459925e-06,90
Slovak Republic,SVK,Summer,2004,10691446.55,5372280.0,1.9901134248401051,2,2,2,6,6,4,2,12,1.1223925540739853e-06,2.233688489803212e-06,6
Sweden,SWE,Summer,2004,42821673.14,8993531.0,4.761386060714084,4,2,1,7,12,4,1,17,3.9699523053246114e-07,1.890247556827235e-06,7
Syrian Arab Republic,SYR,Summer,2004,6241058.232000001,18084007.0,0.3451147874472732,0,0,1,1,0,0,1,1,1.602292372265755e-07,5.5297479148288324e-08,1
Thailand,THA,Summer,2004,2647261.72,65311166.0,0.0405330647442429,3,1,4,8,9,2,4,15,5.66623235121611e-06,2.296697627477666e-07,8
Trinidad and Tobago,TTO,Summer,2004,9756500.371,1361172.0,7.167720443118136,0,0,1,1,0,0,1,1,1.0249576815190593e-07,7.346610127155128e-07,1
Turkiye,TUR,Summer,2004,6031947.927,67785075.0,0.0889863723983487,3,3,4,10,9,6,4,19,3.149894566389217e-06,2.802976909002461e-07,10
Ukraine,UKR,Summer,2004,1416603.76,47451626.0,0.0298536399996071,8,5,9,22,24,10,9,43,3.035428904974811e-05,9.061860177351984e-07,22
United States,USA,Summer,2004,41724631.63,292805298.0,0.1424995787815287,36,39,26,101,108,78,26,212,5.080931615644799e-06,7.240306150471362e-07,101
Uzbekistan,UZB,Summer,2004,465119.8869,25864350.0,0.0179830495218321,2,1,2,5,6,2,2,10,2.1499833229341117e-05,3.866325656743742e-07,5
"Venezuela, RB",VEN,Summer,2004,4287707.147,26226927.0,0.1634849232241352,0,0,2,2,0,0,2,2,4.664497670740758e-07,7.625750435802106e-08,2
Australia,AUS,Winter,2006,36570720.370000005,20450966.0,1.7882148144004544,1,0,1,2,3,0,1,4,1.0937711807507389e-07,1.9558978289827486e-07,2
Austria,AUT,Winter,2006,40669326.96,8268641.0,4.918501959390908,9,7,7,23,27,14,7,48,1.1802506603369666e-06,5.805065185439784e-06,23
Belarus,BLR,Winter,2006,3847434.124,9604924.0,0.4005689294366097,0,1,0,1,0,2,0,2,5.198269640340696e-07,2.082265304754103e-07,1
Canada,CAN,Winter,2006,40504060.73,32571174.0,1.243555443534212,6,9,6,21,18,18,6,42,1.0369330690068813e-06,1.2894837625441442e-06,21
China,CHN,Winter,2006,2099229.435,1311020000.0,0.0016012184673002,2,4,5,11,6,8,5,19,9.050940160811912e-06,1.4492532531921711e-08,11
Czechia,CZE,Winter,2006,15261797.59,10238905.0,1.490569312831792,1,2,1,4,3,4,1,8,5.241846481597847e-07,7.81333550804505e-07,4
Estonia,EST,Winter,2006,12639400.07,1346810.0,9.38469425531441,3,0,0,3,9,0,0,9,7.120591127866719e-07,6.682457065213356e-06,3
Finland,FIN,Winter,2006,41222602.0,5266268.0,7.827668853920841,0,6,3,9,0,12,3,15,3.638780492313416e-07,2.848316872593647e-06,9
France,FRA,Winter,2006,36470212.84,63628261.0,0.5731763255324549,3,2,4,9,9,4,4,17,4.661338302186887e-07,2.671768760111172e-07,9
Italy,ITA,Winter,2006,33529726.6,58143979.0,0.5766672177698744,5,0,6,11,15,0,6,21,6.26309908533522e-07,3.611723924157306e-07,11
Japan,JPN,Winter,2006,35991546.0,127854000.0,0.2815050448167441,1,0,0,1,3,0,0,3,8.33529073744151e-08,2.3464263926040642e-08,1
"Korea, Rep.",KOR,Winter,2006,21743477.45,48438292.0,0.4488902591775944,6,3,2,11,18,6,2,26,1.195760892423397e-06,5.367654169143702e-07,11
Norway,NOR,Winter,2006,74148320.08,4660677.0,15.909345376218948,2,8,9,19,6,16,9,31,4.180809486520197e-07,6.651394207322241e-06,19
Poland,POL,Winter,2006,9035410.467,38141267.0,0.2368932963606059,0,1,1,2,0,2,1,3,3.320269744199104e-07,7.865496445097118e-08,2
Russian Federation,RUS,Winter,2006,6920188.965,143049637.0,0.0483761378926113,8,6,8,22,24,12,8,44,6.35820787879309e-06,3.075855410943825e-07,22
Slovak Republic,SVK,Winter,2006,13170784.98,5373054.0,2.4512660732611287,0,1,0,1,0,2,0,2,1.5185123764734028e-07,3.722277870276383e-07,1
Sweden,SWE,Winter,2006,46593602.16,9080505.0,5.131168603508286,7,2,5,14,21,4,5,30,6.438652220315906e-07,3.3037810121793886e-06,14
Ukraine,UKR,Winter,2006,2391323.975,46787786.0,0.0511100049701005,0,0,2,2,0,0,2,2,8.36356771775351e-07,4.2746198762215424e-08,2
United States,USA,Winter,2006,46302000.88,298379912.0,0.1551780097046211,9,9,7,25,27,18,7,52,1.1230616174615735e-06,1.7427446657333957e-07,25
Afghanistan,AFG,Summer,2008,387849.1743,26427199.0,0.0146761362904937,0,0,1,1,0,0,1,1,2.578321848447468e-06,3.783980284857279e-08,1
Argentina,ARG,Summer,2008,8977506.851,40273769.0,0.2229120113143619,2,0,4,6,6,0,4,10,1.1138950006912114e-06,2.4830057499709054e-07,6
Armenia,ARM,Summer,2008,3908949.06,2983421.0,1.3102237532014422,0,1,4,5,0,2,4,6,1.5349394192412425e-06,2.0111140868151025e-06,5
Australia,AUS,Summer,2008,49679180.53,21249199.0,2.3379319159277485,14,15,17,46,42,30,17,89,1.791494929073058e-06,4.188393171902621e-06,46
Austria,AUT,Summer,2008,51919983.58,8321496.0,6.23926077474531,0,1,2,3,0,2,2,4,7.704162683019093e-08,4.806828003041761e-07,3
Azerbaijan,AZE,Summer,2008,5574603.801999999,8763400.0,0.6361233998219868,1,1,4,6,3,2,4,9,1.6144645107821066e-06,1.0269986534906544e-06,6
Belgium,BEL,Summer,2008,48303397.96,10709973.0,4.510132561491985,2,0,0,2,6,0,0,6,1.242148638273563e-07,5.602255019690526e-07,2
Belarus,BLR,Summer,2008,6377369.732,9527985.0,0.6693303706922292,3,4,7,14,9,8,7,24,3.7633069758483937e-06,2.5188956531732576e-06,14
Brazil,BRA,Summer,2008,8801599.484000001,192672317.0,0.0456817025976803,3,4,10,17,9,8,10,27,3.067624248192841e-06,1.401342985873783e-07,17
Canada,CAN,Summer,2008,46710505.58,33247118.0,1.4049490118211148,3,9,8,20,9,18,8,35,7.492961072762596e-07,1.052722825479189e-06,20
China,CHN,Summer,2008,3468304.602,1324655000.0,0.0026182701171248,48,22,30,100,144,44,30,218,6.285491760853132e-05,1.6457115248876124e-07,100
Cameroon,CMR,Summer,2008,1476009.215,18777081.0,0.0786069578652826,1,0,0,1,3,0,0,3,2.032507635800905e-06,1.5976924208826706e-07,1
Colombia,COL,Summer,2008,5527449.953000001,43815313.0,0.1261533827910803,0,2,1,3,0,4,1,5,9.045762589467266e-07,1.1411535505862985e-07,3
Cuba,CUB,Summer,2008,4992824.494000001,11276609.0,0.4427593875073615,3,10,17,30,9,20,17,46,9.213221905812896e-06,4.0792404879871244e-06,30
Czechia,CZE,Summer,2008,22804577.68,10384603.0,2.195998988117312,3,3,1,7,9,6,1,16,7.016135192028692e-07,1.5407425782189269e-06,7
Dominican Republic,DOM,Summer,2008,5053324.5770000005,9522948.0,0.530647082920121,1,1,0,2,3,2,0,5,9.894476247888951e-07,5.250474957964697e-07,2
Ecuador,ECU,Summer,2008,4260433.184,14496797.0,0.2938878970299439,0,1,0,1,0,2,0,2,4.6943583284229726e-07,1.37961509704523e-07,1
"Egypt, Arab Rep.",EGY,Summer,2008,1941899.973,83844783.0,0.0231606535734012,0,0,2,2,0,0,2,2,1.0299191656665212e-06,2.385360100460872e-08,2
Spain,ESP,Summer,2008,35510722.23,45954106.0,0.7727431849071331,5,11,3,19,15,22,3,40,1.1264203454078831e-06,8.704336452546808e-07,19
Estonia,EST,Summer,2008,18204966.48,1337090.0,13.6153635731327,1,1,0,2,3,2,0,5,2.7465032717819097e-07,3.739464060010919e-06,2
Ethiopia,ETH,Summer,2008,320861.08969999995,84357105.0,0.0038036048024644,4,2,1,7,12,4,1,17,5.298242929952875e-05,2.0152422252992209e-07,7
Finland,FIN,Summer,2008,53772794.24,5313399.0,10.120225159074256,1,1,2,4,3,2,2,7,1.3017735267312752e-07,1.3174241196642676e-06,4
France,FRA,Summer,2008,45515961.75,64379696.0,0.7069924926330811,7,16,20,43,21,32,20,73,1.603832967453445e-06,1.1338978674270224e-06,43
United Kingdom,GBR,Summer,2008,47429936.34,61806995.0,0.7673878391919879,19,13,19,51,57,26,19,102,2.1505405208393326e-06,1.650298643381708e-06,51
Georgia,GEO,Summer,2008,3324735.879,3848449.0,0.863915795428236,3,2,2,7,9,4,2,15,4.511636576831372e-06,3.897674101956398e-06,7
Hungary,HUN,Summer,2008,15772330.08,10038188.0,1.5712327842435307,3,5,2,10,9,10,2,21,1.3314456325403e-06,2.0920110282851844e-06,10
India,IND,Summer,2008,993503.7725,1206734806.0,0.0008232991768864,1,0,2,3,3,0,2,5,5.032693522057059e-06,4.1434124342312205e-09,3
Ireland,IRL,Summer,2008,61353106.56,4489544.0,13.665776871771389,0,1,2,3,0,2,2,4,6.519637267410767e-08,8.909590818132086e-07,3
Iceland,ISL,Summer,2008,56943370.45,317414.0,179.39779105521495,0,1,0,1,0,2,0,2,3.5122613645711945e-08,6.300919304126472e-06,1
Israel,ISR,Summer,2008,30173361.59,7308800.0,4.128360550295534,0,0,1,1,0,0,1,1,3.3141816069026205e-08,1.3682136602451838e-07,1
Italy,ITA,Summer,2008,40944912.42,58826731.0,0.6960256285531148,8,9,10,27,24,18,10,52,1.2699990530349752e-06,8.839518891505292e-07,27
Jamaica,JAM,Summer,2008,5056258.245,2711373.0,1.8648331472652415,5,4,2,11,15,8,2,25,4.944367710000144e-06,9.220420797876204e-06,11
Japan,JPN,Summer,2008,39876303.97,128063000.0,0.3113803672411235,9,8,8,25,27,16,8,51,1.2789550415296423e-06,3.982414905163865e-07,25
Kazakhstan,KAZ,Summer,2008,8458017.154,15776938.0,0.5361000438741661,2,3,4,9,6,6,4,16,1.8916963289005884e-06,1.0141384849202043e-06,9
Kenya,KEN,Summer,2008,915998.9157,39186895.0,0.0233751338476804,6,4,6,16,18,8,6,32,3.493453916978256e-05,8.16599529000703e-07,16
Kyrgyz Republic,KGZ,Summer,2008,966393.6272,5318700.0,0.181697337168857,0,1,2,3,0,2,2,4,4.139100142443489e-06,7.520634741572189e-07,3
"Korea, Rep.",KOR,Summer,2008,21350427.98,49054708.0,0.435237082238875,13,11,8,32,39,22,8,69,3.231785333045113e-06,1.4065928187769458e-06,32
Lithuania,LTU,Summer,2008,14944996.65,3198231.0,4.6728946877195545,0,3,2,5,0,6,2,8,5.35296205636821e-07,2.501382795676735e-06,5
Morocco,MAR,Summer,2008,2889220.947,31634992.0,0.0913299092030748,0,1,1,2,0,2,1,3,1.038342188095731e-06,9.483169776050521e-08,2
Moldova,MDA,Summer,2008,2110561.99,2868833.0,0.7356865979999534,0,0,1,1,0,0,1,1,4.7380745258280716e-07,3.485737928976695e-07,1
Mexico,MEX,Summer,2008,10119836.21,109684489.0,0.0922631477090621,2,0,2,4,6,0,2,8,7.905266284937235e-07,7.29364750926633e-08,4
Norway,NOR,Summer,2008,96944095.61,4768212.0,20.331330823797263,3,5,1,9,9,10,1,20,2.063044672721353e-07,4.194444374537038e-06,9
New Zealand,NZL,Summer,2008,31252962.56,4259800.0,7.336720634771585,3,2,4,9,9,4,4,17,5.439484326442044e-07,3.990797690032396e-06,9
Panama,PAN,Summer,2008,7197110.786,3495276.0,2.059096559470554,1,0,0,1,3,0,0,3,4.1683393367178324e-07,8.583013186941461e-07,1
Poland,POL,Summer,2008,13996025.15,38125759.0,0.367101548063607,4,5,2,11,12,10,2,24,1.7147725688389464e-06,6.294956645977855e-07,11
Romania,ROU,Summer,2008,10435043.98,20537875.0,0.5080878123953915,4,1,4,9,12,2,4,18,1.724956793138499e-06,8.764295235023097e-07,9
Russian Federation,RUS,Summer,2008,11635272.46,142742366.0,0.0815123973775242,24,13,23,60,72,26,23,121,1.0399412683800617e-05,8.476810591748213e-07,60
Singapore,SGP,Summer,2008,40007469.26,4839396.0,8.26703771710354,0,1,0,1,0,2,0,2,4.999066516810717e-08,4.132747144478361e-07,1
Serbia,SRB,Summer,2008,7101040.141000001,7350222.0,0.9660987302152236,0,1,2,3,0,2,2,4,5.632977592824454e-07,5.442012499758511e-07,3
Slovak Republic,SVK,Summer,2008,18753584.94,5379233.0,3.4862934808735746,3,3,0,6,9,6,0,15,7.998470717993825e-07,2.788501632110005e-06,6
Sweden,SWE,Summer,2008,56152552.34,9219637.0,6.090538308612367,0,4,1,5,0,8,1,9,1.602776654835847e-07,9.761772616427306e-07,5
Thailand,THA,Summer,2008,4327797.6,67328239.0,0.0642790850359237,2,2,2,6,6,4,2,12,2.7727729226523905e-06,1.7823130648047994e-07,6
Tajikistan,TJK,Summer,2008,704655.3136999999,7324627.0,0.0962035764688085,0,1,1,2,0,2,1,3,4.257400663379118e-06,4.095771702777493e-07,2
Trinidad and Tobago,TTO,Summer,2008,20011148.270000003,1392803.0,14.367536737069065,1,1,0,2,3,2,0,5,2.4986072425917813e-07,3.589883134944425e-06,2
Tunisia,TUN,Summer,2008,4200315.819999999,10680380.0,0.3932740052320235,1,0,0,1,3,0,0,3,7.142320074398597e-07,2.808888822307821e-07,1
Turkiye,TUR,Summer,2008,10802780.61,71320726.0,0.1514676198052162,1,1,3,5,3,2,3,8,7.405500758382985e-07,1.1216935733379945e-07,5
Ukraine,UKR,Summer,2008,4066547.852,46258189.0,0.0879097937016081,7,4,11,22,21,8,11,40,9.83635295975364e-06,8.647117594681452e-07,22
United States,USA,Summer,2008,48570045.98,304093966.0,0.1597205186899368,36,39,37,112,108,78,37,223,4.591307162686774e-06,7.333259614891537e-07,112
Uzbekistan,UZB,Summer,2008,1082286.025,27302800.0,0.0396401110875075,0,1,3,4,0,2,3,5,4.619850838413994e-06,1.8313140044244546e-07,4
"Venezuela, RB",VEN,Summer,2008,11310778.17,27933833.0,0.4049132165285015,0,0,1,1,0,0,1,1,8.841124677454444e-08,3.5798882308775886e-08,1
Australia,AUS,Winter,2010,52134308.85,22031750.0,2.3663262723115506,2,1,0,3,6,2,0,8,1.5344981407574566e-07,3.631123265287596e-07,3
Austria,AUT,Winter,2010,46903761.59,8363404.0,5.608214261800578,4,6,6,16,12,12,6,30,6.396075492247103e-07,3.5870561795173354e-06,16
Belarus,BLR,Winter,2010,6033686.239,9483836.0,0.636207357339372,1,1,1,3,3,2,1,6,9.944169720357248e-07,6.326553938722686e-07,3
Canada,CAN,Winter,2010,47562083.43,34004889.0,1.3986836842784578,14,7,5,26,42,14,5,61,1.2825342289678582e-06,1.7938597005859952e-06,26
China,CHN,Winter,2010,4550453.108,1337705000.0,0.0034016865512201,5,2,4,11,15,4,4,23,5.054441712532861e-06,1.7193626397449364e-08,11
Czechia,CZE,Winter,2010,19960068.49,10474410.0,1.905603130868469,2,0,4,6,6,0,4,10,5.01000284894313e-07,9.547077114605975e-07,6
Estonia,EST,Winter,2010,14663044.61,1331475.0,11.012632313787345,0,1,0,1,0,2,0,2,1.3639732082899254e-07,1.5020935428753826e-06,1
Finland,FIN,Winter,2010,46505303.18,5363352.0,8.670939960681306,0,1,4,5,0,2,4,6,1.290175440159339e-07,1.1187033780367203e-06,5
France,FRA,Winter,2010,40676064.79,65030575.0,0.6254913906266398,2,3,6,11,6,6,6,18,4.425206836730481e-07,2.7679287781170626e-07,11
United Kingdom,GBR,Winter,2010,39693193.870000005,62766365.0,0.632395931642688,1,0,0,1,3,0,0,3,7.55797079425093e-08,4.779629981758542e-08,1
Italy,ITA,Winter,2010,36035645.0,59277417.0,0.607915236927412,1,1,3,5,3,2,3,8,2.220024090036407e-07,1.3495864706790446e-07,5
Japan,JPN,Winter,2010,44968156.23,128070000.0,0.3511217008667135,0,3,2,5,0,6,2,8,1.779036694117979e-07,6.24658389943e-08,5
Kazakhstan,KAZ,Winter,2010,9070488.253,16321872.0,0.5557259763463406,0,1,0,1,0,2,0,2,2.2049529685885594e-07,1.225349641266639e-07,1
"Korea, Rep.",KOR,Winter,2010,23087225.64,49554112.0,0.4658992908600602,6,6,2,14,18,12,2,32,1.3860478733554752e-06,6.457587212944104e-07,14
Norway,NOR,Winter,2010,87693790.07000001,4889252.0,17.936033992520738,9,8,6,23,27,16,6,49,5.587624843319764e-07,1.0021982912723663e-05,23
Poland,POL,Winter,2010,12504250.19,38042794.0,0.3286890597467684,1,3,2,6,3,6,2,11,8.797008883265154e-07,2.891480578424393e-07,6
Russian Federation,RUS,Winter,2010,10674996.09,142849468.0,0.0747289873701174,3,5,7,15,9,10,7,26,2.4355980817975177e-06,1.8200977829332906e-07,15
Slovak Republic,SVK,Winter,2010,16908847.96,5391428.0,3.136246641891536,1,1,1,3,3,2,1,6,3.548438080579915e-07,1.1128777014178804e-06,3
Sweden,SWE,Winter,2010,52869044.29,9378126.0,5.637484961281177,5,2,4,11,15,4,4,23,4.3503718118752473e-07,2.452515566542825e-06,11
United States,USA,Winter,2010,48650643.13,309327143.0,0.1572789334235696,9,15,13,37,27,30,13,70,1.4388299002122566e-06,2.262976320833248e-07,37
Afghanistan,AFG,Summer,2012,663141.0528000001,30466479.0,0.0217662517811789,0,0,1,1,0,0,1,1,1.5079748053263637e-06,3.2822959292407896e-08,1
Argentina,ARG,Summer,2012,13082664.33,41733271.0,0.3134828403457759,1,1,2,4,3,2,2,7,5.350592068580575e-07,1.6773187991902193e-07,4
Armenia,ARM,Summer,2012,3643715.183,2914421.0,1.2502363876049478,0,1,1,2,0,2,1,3,8.233354829698829e-07,1.0293639800152415e-06,2
Australia,AUS,Summer,2012,68044714.82,22733465.0,2.9931519379029985,8,15,12,35,24,30,12,66,9.699504241378787e-07,2.9032089916781275e-06,35
Azerbaijan,AZE,Summer,2012,7496294.648,9295784.0,0.8064187644635461,2,2,5,9,6,4,5,15,2.0009885822727068e-06,1.613634740222019e-06,9
Belgium,BEL,Summer,2012,44670560.68,11106932.0,4.021863164373384,0,1,2,3,0,2,2,4,8.954443237581498e-08,3.601354541470138e-07,3
Belarus,BLR,Summer,2012,6953132.515000001,9446836.0,0.7360276514803475,2,5,3,10,6,10,3,19,2.732581316264472e-06,2.011255408689216e-06,10
Brazil,BRA,Summer,2012,12327317.44,199977707.0,0.061643458288078,3,5,9,17,9,10,9,28,2.2713781920748524e-06,1.4001560683961638e-07,17
Brunei Darussalam,BRN,Summer,2012,46842960.26,406634.0,115.19686071504104,1,0,0,1,3,0,0,3,6.40437748457531e-08,7.377641810571669e-06,1
Canada,CAN,Summer,2012,52669089.96,34714222.0,1.5172193679005683,2,6,10,18,6,12,10,28,5.316211087236336e-07,8.065858425402707e-07,18
China,CHN,Summer,2012,6300615.118,1354190000.0,0.0046526817640065,38,31,22,91,114,62,22,198,3.1425503112282e-05,1.4621286525524486e-07,91
Cameroon,CMR,Summer,2012,1433724.035,21032684.0,0.0681664800840444,0,0,1,1,0,0,1,1,6.974842965508353e-07,4.7545049409766256e-08,1
Colombia,COL,Summer,2012,8101829.092,45782417.0,0.1769637695624501,1,3,5,9,3,6,5,14,1.7280048543388848e-06,3.0579425284602165e-07,9
Cuba,CUB,Summer,2012,6467337.914,11309290.0,0.5718606485464605,5,3,7,15,15,6,7,28,4.329447505655725e-06,2.4758406584321384e-06,15
Cyprus,CYP,Summer,2012,28993349.61,1156556.0,25.06869499617831,0,1,0,1,0,2,0,2,6.898133630307367e-08,1.729272080210556e-06,1
Czechia,CZE,Summer,2012,19870801.21,10510785.0,1.8905154286763548,4,3,4,11,12,6,4,22,1.1071521358146584e-06,2.093088194649591e-06,11
Dominican Republic,DOM,Summer,2012,6049471.741,10030882.0,0.6030847278434738,1,1,0,2,3,2,0,5,8.265184488940982e-07,4.984606538089073e-07,2
"Egypt, Arab Rep.",EGY,Summer,2012,3059135.428,91240376.0,0.0335283079938206,0,3,1,4,0,6,1,7,2.28822821504717e-06,7.672042035425193e-08,4
Spain,ESP,Summer,2012,28322946.59,46773055.0,0.6055398047016599,4,10,6,20,12,20,6,38,1.3416683140382252e-06,8.124335688571123e-07,20
Estonia,EST,Summer,2012,17403205.330000002,1322696.0,13.157373523470246,0,1,1,2,0,2,1,3,1.723820378553219e-07,2.268094860799458e-06,2
Ethiopia,ETH,Summer,2012,458550.9208,94451280.0,0.0048548936636962,3,2,3,8,9,4,3,16,3.489252616064096e-05,1.693995041676513e-07,8
Finland,FIN,Summer,2012,47708061.28,5413971.0,8.812027489618988,0,2,1,3,0,4,1,5,1.0480409108755969e-07,9.235365316881084e-07,3
France,FRA,Summer,2012,40870852.36,65662240.0,0.6224407263596247,11,11,13,35,33,22,13,68,1.6637773883705714e-06,1.0356028061180977e-06,35
Gabon,GAB,Summer,2012,9348515.572,1836705.0,5.089829652557161,0,1,0,1,0,2,0,2,2.1393770856950334e-07,1.0889064928771904e-06,1
United Kingdom,GBR,Summer,2012,42485586.07,63700215.0,0.6669614234426053,29,18,18,65,87,36,18,141,3.3187726248541308e-06,2.213493313955063e-06,65
Georgia,GEO,Summer,2012,4421818.242000001,3728874.0,1.18583203454984,1,2,3,6,3,4,3,10,2.2615131271150967e-06,2.681774712688066e-06,6
"Hong Kong SAR, China",HKG,Summer,2012,36730876.7,7150100.0,5.137113704703431,0,0,1,1,0,0,1,1,2.7225051233258478e-08,1.3985818380162516e-07,1
Hungary,HUN,Summer,2012,12984836.57,9920362.0,1.308907534825846,8,4,6,18,24,8,6,38,2.926490433294687e-06,3.830505378735171e-06,18
India,IND,Summer,2012,1434018.198,1274487215.0,0.001125172682097,0,2,4,6,0,4,4,8,5.578729761698603e-06,6.277034328665274e-09,6
Ireland,IRL,Summer,2012,49054697.43,4599533.0,10.665147403008088,1,1,4,6,3,2,4,9,1.8346866806879827e-07,1.9567203887872965e-06,6
Italy,ITA,Summer,2012,35051521.27,59539717.0,0.588708227652476,8,9,11,28,24,18,11,53,1.512059907236089e-06,8.901621080933253e-07,28
Jamaica,JAM,Summer,2012,5365242.2930000005,2759817.0,1.944057266478176,4,5,3,12,12,10,3,25,4.659621809180426e-06,9.058571637177393e-06,12
Japan,JPN,Summer,2012,49145280.43,127629000.0,0.3850635860972036,7,14,17,38,21,28,17,66,1.342957033158189e-06,5.171238511623534e-07,38
Kazakhstan,KAZ,Summer,2012,12386699.27,16792090.0,0.7376508385793549,3,1,7,11,9,2,7,18,1.4531716325425891e-06,1.0719332733447712e-06,11
Kenya,KEN,Summer,2012,1289780.822,43725806.0,0.0294970165215479,2,4,7,13,6,8,7,21,1.6281836139753053e-05,4.802655896154321e-07,13
"Korea, Rep.",KOR,Summer,2012,25466760.52,50199853.0,0.5073074719959837,13,9,8,30,39,18,8,65,2.5523466146765337e-06,1.2948245087490594e-06,30
Lithuania,LTU,Summer,2012,14367709.42,2987773.0,4.808835684638693,2,0,3,5,6,0,3,9,6.264046506586434e-07,3.0122770371109185e-06,5
Morocco,MAR,Summer,2012,2907449.219,33352169.0,0.0871742170351799,0,0,1,1,0,0,1,1,3.4394409830619297e-07,2.9983057473713326e-08,1
Mexico,MEX,Summer,2012,10376057.67,115755909.0,0.0896373909516791,1,3,4,8,3,6,4,13,1.252884324032482e-06,1.123052819705299e-07,8
Montenegro,MNE,Summer,2012,6586721.279,620601.0,10.613455793658083,0,1,0,1,0,2,0,2,3.036412071020017e-07,3.222682528710073e-06,1
Norway,NOR,Summer,2012,101524141.9,5018573.0,20.229683198789772,2,1,1,4,6,2,1,9,8.864886549708429e-08,1.793338464938141e-06,4
New Zealand,NZL,Summer,2012,39973380.76,4408100.0,9.068165595154374,6,2,5,13,18,4,5,27,6.754494988079162e-07,6.125087906354211e-06,13
Poland,POL,Summer,2012,13010923.39,38063164.0,0.3418245364468387,3,2,6,11,9,4,6,19,1.4603114191420966e-06,4.991702739162725e-07,11
Qatar,QAT,Summer,2012,98041362.24,1905660.0,51.4474576996946,0,1,1,2,0,2,1,3,3.0599330032320045e-08,1.5742577374767796e-06,2
Romania,ROU,Summer,2012,8930729.912,20058035.0,0.4452445073507948,2,4,1,7,6,8,1,15,1.6795939579188116e-06,7.478299843429329e-07,7
Russian Federation,RUS,Summer,2012,15420875.0,143201721.0,0.1076863803892412,19,21,26,66,57,42,26,125,8.10589541773732e-06,8.728945373498689e-07,66
Singapore,SGP,Summer,2012,55546488.54,5312437.0,10.45593360260084,0,0,2,2,0,0,2,2,3.600587638514296e-08,3.764750527865084e-07,2
Serbia,SRB,Summer,2012,6015945.227999999,7199077.0,0.8356550746713779,1,1,2,4,3,2,2,7,1.1635744234205985e-06,9.723468716892458e-07,4
Slovak Republic,SVK,Summer,2012,17498353.9,5407579.0,3.2358942698756685,0,1,3,4,0,2,3,5,2.857411633445133e-07,9.24628193134118e-07,4
Sweden,SWE,Summer,2012,58037821.32,9519374.0,6.096810706250222,1,4,3,8,3,8,3,14,2.4122201146746973e-07,1.4706849420980834e-06,8
Thailand,THA,Summer,2012,5748631.241,69157023.0,0.0831243305687117,0,2,2,4,0,4,2,6,1.0437267148407789e-06,8.675908446782044e-08,4
Tajikistan,TJK,Summer,2012,959361.905,7956382.0,0.1205776576589711,0,0,1,1,0,0,1,1,1.042359504570905e-06,1.2568526749972537e-07,1
Trinidad and Tobago,TTO,Summer,2012,18961233.59,1430377.0,13.25610911668742,1,1,2,4,3,2,2,7,3.691742927365097e-07,4.893814707591075e-06,4
Tunisia,TUN,Summer,2012,4233894.568,11174383.0,0.378892916772228,2,0,1,3,6,0,1,7,1.6533241174464692e-06,6.264327972291624e-07,3
Turkiye,TUR,Summer,2012,11697480.51,75277439.0,0.1553915843231595,1,1,1,3,3,2,1,6,5.129309679012238e-07,7.970515575058287e-08,3
Uganda,UGA,Summer,2012,796711.135,34273295.0,0.0232458284212241,1,0,0,1,3,0,0,3,3.765480195027022e-06,8.753170653711586e-08,1
Ukraine,UKR,Summer,2012,4004804.443,45593342.0,0.0878374838808701,5,4,10,19,15,8,10,33,8.240102724037055e-06,7.23789890199319e-07,19
United States,USA,Summer,2012,51784418.57,313877662.0,0.1649828096718778,47,27,30,104,141,54,30,225,4.344936299629481e-06,7.168397985582038e-07,104
Uzbekistan,UZB,Summer,2012,2267623.275,29774500.0,0.0761599111655947,0,0,3,3,0,0,3,3,1.3229710741966169e-06,1.0075735948546576e-07,3
"Venezuela, RB",VEN,Summer,2012,12937927.6,29470426.0,0.4390139321365766,1,0,0,1,3,0,0,3,2.31876394176143e-07,1.0179696757691932e-07,1
Australia,AUS,Winter,2014,62513411.22,23475686.0,2.6629002969284903,0,2,1,3,0,4,1,5,7.998283732115938e-08,2.1298632125169849e-07,3
Austria,AUT,Winter,2014,51786377.17,8546356.0,6.059468757210675,4,8,5,17,12,16,5,33,6.372332223911001e-07,3.861294802135553e-06,17
Belarus,BLR,Winter,2014,8341399.679,9448515.0,0.8828265266023285,5,0,1,6,15,0,1,16,1.918143311161676e-06,1.6933877969183518e-06,6
Canada,CAN,Winter,2014,50955998.32,35437435.0,1.43791440661549,10,10,5,25,30,20,5,55,1.0793626229164222e-06,1.5520310654538062e-06,25
China,CHN,Winter,2014,7636116.601,1371860000.0,0.0055662506385491,3,4,2,9,9,8,2,19,2.4881757302542797e-06,1.3849809747350314e-08,9
Czechia,CZE,Winter,2014,19890919.91,10525347.0,1.8898113202348577,2,4,3,9,6,8,3,17,8.546613267219173e-07,1.6151486502060218e-06,9
Finland,FIN,Winter,2014,50327240.29,5461512.0,9.214891460460034,1,3,1,5,3,6,1,10,1.9869955003249002e-07,1.830994786791643e-06,5
France,FRA,Winter,2014,43068548.72,66312067.0,0.6494828267078449,4,4,7,15,12,8,7,27,6.269075880762578e-07,4.071657123883652e-07,15
United Kingdom,GBR,Winter,2014,47447588.93,64602298.0,0.7344566741263601,1,1,3,5,3,2,3,8,1.686070921707423e-07,1.2383460414984e-07,5
Italy,ITA,Winter,2014,35565721.38,60789140.0,0.5850670264458422,0,2,6,8,0,4,6,10,2.811696097249244e-07,1.6450306748869945e-07,8
Japan,JPN,Winter,2014,38475395.25,127276000.0,0.3022989035639083,1,4,3,8,3,8,3,14,3.638689065838771e-07,1.0999717150130425e-07,8
Kazakhstan,KAZ,Winter,2014,12807260.69,17288285.0,0.7408057357916068,0,0,1,1,0,0,1,1,7.808070938860541e-08,5.784263736975645e-08,1
"Korea, Rep.",KOR,Winter,2014,29249575.22,50746659.0,0.5763842545772323,3,3,2,8,9,6,2,17,5.812050216844141e-07,3.349974231801152e-07,8
Norway,NOR,Winter,2014,97019182.75,5137232.0,18.88549762790545,11,6,9,26,33,12,9,54,5.565909593275769e-07,1.0511497242094575e-05,26
Poland,POL,Winter,2014,14182137.5,38011735.0,0.3730989258974893,4,1,1,6,12,2,1,15,1.057668493201395e-06,3.9461497876905643e-07,6
Russian Federation,RUS,Winter,2014,14095648.44,143819667.0,0.0980091856282771,10,10,9,29,30,20,9,59,4.185688955789536e-06,4.10235965850206e-07,29
Slovak Republic,SVK,Winter,2014,18719988.14,5418649.0,3.454733484305774,1,0,0,1,3,0,0,3,1.602565117864439e-07,5.536435373466707e-07,1
Sweden,SWE,Winter,2014,60020360.46,9696110.0,6.190148467787598,2,7,6,15,6,14,6,26,4.331863354490757e-07,2.68148773064662e-06,15
Ukraine,UKR,Winter,2014,3104643.311,45272155.0,0.068577325532659,1,0,1,2,3,0,1,4,1.2883927715070131e-06,8.83545305055613e-08,2
United States,USA,Winter,2014,55123849.79,318386329.0,0.1731351027637873,9,9,10,28,27,18,10,55,9.977532449117429e-07,1.727461105906969e-07,28
Argentina,ARG,Summer,2016,12790242.47,43590368.0,0.2934190064649144,3,1,0,4,9,2,0,11,8.600306073790954e-07,2.5234932634659106e-07,4
Armenia,ARM,Summer,2016,3679951.972,2865835.0,1.2840767078355872,1,3,0,4,3,6,0,9,2.445684092748806e-06,3.140445978222752e-06,4
Australia,AUS,Summer,2016,49875565.14,24190907.0,2.061748455318356,8,11,10,29,24,22,10,56,1.1227942950181875e-06,2.3149194033940108e-06,29
Austria,AUT,Summer,2016,45307587.86,8736668.0,5.1859115923828165,0,0,1,1,0,0,1,1,2.2071358181547653e-08,1.1446011225332129e-07,1
Azerbaijan,AZE,Summer,2016,3880738.731,9757812.0,0.397705831081804,1,7,10,18,3,14,10,27,6.9574382280155615e-06,2.767013752673243e-06,18
Burundi,BDI,Summer,2016,242065.6705,10903327.0,0.0222010832565142,0,1,0,1,0,2,0,2,8.262220726585846e-06,1.8343025023463025e-07,1
Belgium,BEL,Summer,2016,42012622.72,11331422.0,3.7076214017975855,2,2,2,6,6,4,2,12,2.856284426700986e-07,1.059002127005772e-06,6
Belarus,BLR,Summer,2016,5039681.886,9469379.0,0.5322082774382565,1,4,4,9,3,8,4,15,2.9763783388132685e-06,1.584053188704349e-06,9
Brazil,BRA,Summer,2016,8680768.792000001,206859578.0,0.0419645484919243,7,6,6,19,21,12,6,39,4.492689637805066e-06,1.885336921648366e-07,19
Brunei Darussalam,BRN,Summer,2016,26762945.65,425994.0,62.82470093475496,1,1,0,2,3,2,0,5,1.868254737497477e-07,1.1737254515321812e-05,2
Canada,CAN,Summer,2016,42315603.71,36109487.0,1.171869423401113,4,3,15,22,12,6,15,33,7.798541697799636e-07,9.13887256277e-07,22
China,CHN,Summer,2016,8094363.367,1387790000.0,0.0058325563428184,26,18,26,70,78,36,26,140,1.7295986559087224e-05,1.0087981611050665e-07,70
Cote d'Ivoire,CIV,Summer,2016,1980878.142,24213622.0,0.0818084193269391,1,0,1,2,3,0,1,4,2.019306445555196e-06,1.6519626844757058e-07,2
Colombia,COL,Summer,2016,5938463.856000001,47625955.0,0.1246896541182218,3,2,3,8,9,4,3,16,2.6942994666599176e-06,3.359512685887349e-07,8
Cuba,CUB,Summer,2016,8055889.907,11342012.0,0.7102699156904436,5,2,4,11,15,4,4,23,2.8550539127917603e-06,2.0278589019302747e-06,11
Czechia,CZE,Summer,2016,18575232.03,10566332.0,1.7579640721113057,1,2,7,10,3,4,7,14,7.536917965487186e-07,1.3249630997776712e-06,10
Dominican Republic,DOM,Summer,2016,7191076.572,10527592.0,0.683069458998791,0,0,1,1,0,0,1,1,1.3906123651828637e-07,9.498848359624881e-08,1
"Egypt, Arab Rep.",EGY,Summer,2016,3331612.461,99784030.0,0.0333882331771927,0,0,3,3,0,0,3,3,9.0046487552743e-07,3.006493123198171e-08,3
Spain,ESP,Summer,2016,26537159.49,46484062.0,0.570887275083662,7,4,6,17,21,8,6,35,1.3189052887589215e-06,7.52946246393011e-07,17
Estonia,EST,Summer,2016,18295342.93,1315790.0,13.904455065017974,0,0,1,1,0,0,1,1,5.46587185507323e-08,7.599996960001216e-07,1
Ethiopia,ETH,Summer,2016,705616.305,105293228.0,0.0067014405237913,1,2,5,8,3,4,5,12,1.700640973708792e-05,1.1396744337632047e-07,8
Finland,FIN,Summer,2016,43814026.510000005,5495303.0,7.972995576404068,0,0,1,1,0,0,1,1,2.282374115448537e-08,1.819735872617033e-07,1
France,FRA,Summer,2016,37062533.57,66724104.0,0.5554594419132253,10,18,14,42,30,36,14,80,2.158514065124663e-06,1.1989670179759926e-06,42
United Kingdom,GBR,Summer,2016,41146077.36,65611593.0,0.6271159634852944,27,23,17,67,81,46,17,144,3.4997260793562074e-06,2.19473409219008e-06,67
Georgia,GEO,Summer,2016,4062169.888,3727505.0,1.089782545697457,2,1,4,7,6,2,4,12,2.954086197982274e-06,3.219311577046845e-06,7
Hungary,HUN,Summer,2016,13104699.55,9814023.0,1.3353035294496456,8,3,4,15,24,6,4,34,2.594489089221432e-06,3.4644304379559737e-06,15
India,IND,Summer,2016,1714280.3550000002,1338636340.0,0.0012806169261772,0,1,1,2,0,2,1,3,1.7500054709546033e-06,2.241086627007302e-09,2
Ireland,IRL,Summer,2016,62895911.12,4755335.0,13.22638912295348,0,2,0,2,0,4,0,4,6.359713896771993e-08,8.411605070936117e-07,2
Israel,ISR,Summer,2016,37690473.95,8546000.0,4.410305868242453,0,0,2,2,0,0,2,2,5.3063806060204775e-08,2.340276152586005e-07,2
Italy,ITA,Summer,2016,30960731.51,60627498.0,0.5106714367464084,8,12,8,28,24,24,8,56,1.808742793493512e-06,9.23673281058044e-07,28
Jamaica,JAM,Summer,2016,5022704.716999999,2802695.0,1.792098218678807,6,3,2,11,18,6,2,26,5.176493834487145e-06,9.27678537978624e-06,11
Jordan,JOR,Summer,2016,4003404.749,9964656.0,0.4017604570594308,1,0,0,1,3,0,0,3,7.493621524901678e-07,3.010640808874887e-07,1
Japan,JPN,Summer,2016,39375473.16,127076000.0,0.3098576691113979,12,8,21,41,36,16,21,73,1.8539459755408811e-06,5.744593786395543e-07,41
Kazakhstan,KAZ,Summer,2016,7714841.844,17794055.0,0.4335628862561119,2,5,10,17,6,10,10,26,3.3701274148893624e-06,1.4611621690502811e-06,17
Kenya,KEN,Summer,2016,1562076.142,47894670.0,0.0326148221085978,6,6,1,13,18,12,1,31,1.984538343970175e-05,6.47253650562787e-07,13
"Korea, Rep.",KOR,Summer,2016,29288870.44,51217803.0,0.5718494102529154,9,3,9,21,27,6,9,42,1.4339917985584152e-06,8.200273643131472e-07,21
Lithuania,LTU,Summer,2016,15008313.24,2868231.0,5.232602687858823,0,1,3,4,0,2,3,5,3.331486969950795e-07,1.7432347673531176e-06,4
Morocco,MAR,Summer,2016,3132944.58,35107264.0,0.0892392121470929,0,0,1,1,0,0,1,1,3.191885379600299e-07,2.8484133653935553e-08,1
Mexico,MEX,Summer,2016,8875062.256,121519221.0,0.0730342260505438,0,3,2,5,0,6,2,8,9.014021275841292e-07,6.583320674842048e-08,5
Norway,NOR,Summer,2016,70460560.53,5234519.0,13.460751700395011,0,0,4,4,0,0,4,4,5.6769346850383335e-08,7.641580821466118e-07,4
New Zealand,NZL,Summer,2016,40058196.16,4714100.0,8.497527875946627,4,9,5,18,12,18,5,35,8.73728808461654e-07,7.424534905920536e-06,18
Poland,POL,Summer,2016,12378759.44,37970087.0,0.3260134600165651,2,3,6,11,6,6,6,18,1.4541037078267998e-06,4.740573810115316e-07,11
Qatar,QAT,Summer,2016,58467235.57,2595166.0,22.529285436846816,0,1,0,1,0,2,0,2,3.420719280639661e-08,7.706636107285623e-07,1
Romania,ROU,Summer,2016,9404341.874,19702267.0,0.4773228316315072,1,1,2,4,3,2,2,7,7.443370406761544e-07,3.552890639437584e-07,4
Russian Federation,RUS,Summer,2016,8704898.438000001,144342397.0,0.0603072875255078,19,17,20,56,57,34,20,111,1.2751441132896534e-05,7.690048267661788e-07,56
Singapore,SGP,Summer,2016,56860413.24,5607283.0,10.140457194687697,1,0,0,1,3,0,0,3,5.276078433228074e-08,5.350184750796419e-07,1
Serbia,SRB,Summer,2016,5765200.762,7058322.0,0.8167948078877671,2,4,2,8,6,8,2,16,2.775271956782552e-06,2.266827724776512e-06,8
Slovak Republic,SVK,Summer,2016,16563440.5,5430798.0,3.049909147790067,2,2,0,4,6,4,0,10,6.037393016263741e-07,1.8413500189106648e-06,4
Sweden,SWE,Summer,2016,51965157.15,9923085.0,5.236794520050972,2,6,3,11,6,12,3,21,4.041169343408788e-07,2.116277347216113e-06,11
Thailand,THA,Summer,2016,5854461.088,70607037.0,0.0829161134179869,2,2,2,6,6,4,2,12,2.049718978335449e-06,1.699547312826624e-07,6
Tajikistan,TJK,Summer,2016,801391.2831,8725318.0,0.0918466562594051,1,0,0,1,3,0,0,3,3.7434896825869903e-06,3.438270100871969e-07,1
Trinidad and Tobago,TTO,Summer,2016,15991108.79,1469330.0,10.88326569933235,0,0,1,1,0,0,1,1,6.253475059999264e-08,6.805823062212028e-07,1
Tunisia,TUN,Summer,2016,3796167.92,11685667.0,0.3248567599949579,0,0,3,3,0,0,3,3,7.902706263847254e-07,2.567247552065278e-07,3
Turkiye,TUR,Summer,2016,10734379.97,81019394.0,0.1324914867914218,1,3,4,8,3,6,4,13,1.2110620302552977e-06,1.6045540898516225e-07,8
Ukraine,UKR,Summer,2016,2187730.469,45004673.0,0.0486111846429814,2,5,4,11,6,10,4,20,9.141893977982532e-06,4.443982961502688e-07,11
United States,USA,Summer,2016,57866744.93,323071755.0,0.1791142185425649,46,37,38,121,138,74,38,250,4.3202706546293374e-06,7.738219021963093e-07,121
Uzbekistan,UZB,Summer,2016,2704677.188,31847900.0,0.0849248204120208,4,2,7,13,12,4,7,23,8.503787476762643e-06,7.221826242860597e-07,13
Australia,AUS,Winter,2018,57207871.51,24966643.0,2.291372192488994,0,2,1,3,0,4,1,5,8.740055988844115e-08,2.0026721253634299e-07,3
Austria,AUT,Winter,2018,51466556.56,8840521.0,5.821665551159258,5,3,6,14,15,6,6,27,5.246125213083423e-07,3.0541186430075785e-06,14
Belgium,BEL,Winter,2018,47544981.15,11427054.0,4.160738292651807,0,1,0,1,0,2,0,2,4.2065428392750567e-08,1.750232387105198e-07,1
Belarus,BLR,Winter,2018,6360062.473,9438785.0,0.6738221575128579,2,1,0,3,6,2,0,8,1.257849279619804e-06,8.475667154194105e-07,3
Canada,CAN,Winter,2018,46548638.41,37065084.0,1.2558622128038344,11,8,10,29,33,16,10,59,1.267491424353351e-06,1.5917945848982833e-06,29
China,CHN,Winter,2018,9905342.004,1402760000.0,0.0070613233938806,1,6,2,9,3,12,2,17,1.716245637266741e-06,1.211896546807722e-08,9
Czechia,CZE,Winter,2018,23424480.46,10629928.0,2.2036349126729737,2,2,3,7,6,4,3,13,5.549749554616163e-07,1.2229621875143465e-06,7
Spain,ESP,Winter,2018,30379721.11,46797754.0,0.6491704945925396,0,0,2,2,0,0,2,2,6.58333890807729e-08,4.2737093750268447e-08,2
Finland,FIN,Winter,2018,49987626.16,5515525.0,9.063076708019636,1,1,4,6,3,2,4,9,1.8004455685078686e-07,1.6317576296000834e-06,6
France,FRA,Winter,2018,41557854.86,67158348.0,0.6188040072099451,5,4,6,15,15,8,6,29,6.978223514590714e-07,4.3181526740354004e-07,15
United Kingdom,GBR,Winter,2018,43306308.3,66460344.0,0.6516112570828703,1,0,4,5,3,0,4,7,1.616392686143603e-07,1.0532596701575905e-07,5
Hungary,HUN,Winter,2018,16425101.3,9775564.0,1.680220322837639,1,0,0,1,3,0,0,3,1.8264727536261832e-07,3.0688766397519365e-07,1
Italy,ITA,Winter,2018,34622169.67,60421760.0,0.5730082948593355,3,2,5,10,9,4,5,18,5.19898093376769e-07,2.97905919986442e-07,10
Japan,JPN,Winter,2018,39727116.6,126811000.0,0.3132781588348014,4,5,4,13,12,10,4,26,6.544648145946741e-07,2.0502953213837922e-07,13
Kazakhstan,KAZ,Winter,2018,9812626.371,18276452.0,0.5368999612725709,0,0,1,1,0,0,1,1,1.0190951557631664e-07,5.4715214966230864e-08,1
"Korea, Rep.",KOR,Winter,2018,33436923.06,51585058.0,0.6481900836478657,5,8,4,17,15,16,4,35,1.0467470328294018e-06,6.784910467678451e-07,17
Liechtenstein,LIE,Winter,2018,175283631.8,38181.0,4590.86016081297,0,0,1,1,0,0,1,1,5.705039253984695e-09,2.619103742699248e-05,1
Norway,NOR,Winter,2018,82267809.32,5311916.0,15.487407805394511,14,14,11,39,42,28,11,81,9.84589241764436e-07,1.5248735108009992e-05,39
New Zealand,NZL,Winter,2018,43250440.970000006,4900600.0,8.825539927763948,0,0,2,2,0,0,2,2,4.6242303087436014e-08,4.081132922499286e-07,2
Poland,POL,Winter,2018,15504580.48,37974750.0,0.4082865714718333,1,0,1,2,3,0,1,4,2.5798827676503506e-07,1.0533314900032259e-07,2
Slovak Republic,SVK,Winter,2018,19486393.68,5446771.0,3.577604727645058,1,2,0,3,3,4,0,7,3.592250118186056e-07,1.2851651005705949e-06,3
Sweden,SWE,Winter,2018,54589060.39,10175214.0,5.364905385773705,7,6,1,14,21,12,1,34,6.228354134893362e-07,3.3414530642795324e-06,14
Ukraine,UKR,Winter,2018,3096561.768,44622518.0,0.0693945995606971,1,0,0,1,3,0,0,3,9.68816456691459e-07,6.723063005991728e-08,1
United States,USA,Winter,2018,62823309.44,326838199.0,0.1922153213186687,9,8,6,23,27,16,6,49,7.799652778050147e-07,1.4992127649069564e-07,23
Argentina,ARG,Summer,2020,8496424.141999999,45376763.0,0.1872417418139764,0,1,2,3,0,2,2,4,4.707862899907475e-07,8.815084496000739e-08,3
Armenia,ARM,Summer,2020,4505867.364,2805608.0,1.606021712227795,0,2,2,4,0,4,2,6,1.331597118889361e-06,2.1385738848762906e-06,4
Australia,AUS,Summer,2020,51720370.76,25655289.0,2.015973032305346,17,7,22,46,51,14,22,87,1.6821225123019595e-06,3.3911136218344687e-06,46
Austria,AUT,Summer,2020,48809226.88,8916864.0,5.473810846503883,1,1,5,7,3,2,5,10,2.0487929515018778e-07,1.1214705080171684e-06,7
Azerbaijan,AZE,Summer,2020,4229910.649,10093121.0,0.4190884711478244,0,3,4,7,0,6,4,10,2.364116131475287e-06,9.907738151558868e-07,7
Belgium,BEL,Summer,2020,45517794.93,11538604.0,3.944826855137762,3,1,3,7,9,2,3,14,3.075720170876037e-07,1.2133183528960696e-06,7
Belarus,BLR,Summer,2020,6542797.491,9379952.0,0.6975299544176772,1,3,3,7,3,6,3,12,1.8340778568351996e-06,1.2793242438767275e-06,7
Brazil,BRA,Summer,2020,6794489.159,213196304.0,0.0318696385984252,7,6,8,21,21,12,8,41,6.03430207047888e-06,1.92311026179891e-07,21
Brunei Darussalam,BRN,Summer,2020,27179411.99,441725.0,61.530164672590416,0,1,0,1,0,2,0,2,7.358510922664004e-08,4.527703888165714e-06,1
Canada,CAN,Summer,2020,43258263.870000005,38037204.0,1.1372619257188306,7,6,11,24,21,12,11,44,1.0171466920685736e-06,1.1567622057604445e-06,24
China,CHN,Summer,2020,10408669.76,1411100000.0,0.0073762807455176,38,32,18,88,114,64,18,196,1.8830456198468156e-05,1.3889873148607468e-07,88
Cote d'Ivoire,CIV,Summer,2020,2288119.498,26811790.0,0.0853400499556352,0,0,1,1,0,0,1,1,4.37040111267825e-07,3.729702492821255e-08,1
Colombia,COL,Summer,2020,5307215.228,50930662.0,0.1042047171505448,0,4,1,5,0,8,1,9,1.6958046005968386e-06,1.7671083874778614e-07,5
Cuba,CUB,Summer,2020,9499590.202,11300698.0,0.8406197742829691,7,3,5,15,21,6,5,32,3.368566361237653e-06,2.8316834942407983e-06,15
Czechia,CZE,Summer,2020,22992879.38,10697858.0,2.149297493012152,4,4,3,11,12,8,3,23,1.00030968805091e-06,2.149963104763589e-06,11
Dominican Republic,DOM,Summer,2020,7167919.159,10999664.0,0.6516489193669915,0,3,2,5,0,6,2,8,1.1160840158130472e-06,7.272949428273446e-07,5
Ecuador,ECU,Summer,2020,5645199.289999999,17588595.0,0.3209579440540873,2,1,0,3,6,2,0,8,1.4171333178921309e-06,4.548401961612056e-07,3
"Egypt, Arab Rep.",EGY,Summer,2020,3398801.432,107465134.0,0.0316270152512907,1,1,4,6,3,2,4,9,2.6479922937728127e-06,8.374809266045302e-08,6
Spain,ESP,Summer,2020,26959675.44,47365655.0,0.5691819407965539,3,8,6,17,9,16,6,31,1.1498654747900038e-06,6.544826625959252e-07,17
Estonia,EST,Summer,2020,23595243.68,1329522.0,17.747163025508417,1,0,1,2,3,0,1,4,1.6952569145918648e-07,3.0086000833382222e-06,2
Ethiopia,ETH,Summer,2020,918652.5941,117190911.0,0.0078389406333738,1,1,2,4,3,2,2,7,7.619855476332563e-06,5.973159471385968e-08,4
Finland,FIN,Summer,2020,49170752.15,5529543.0,8.892371783707985,0,0,2,2,0,0,2,2,4.0674586264184295e-08,3.6169354320962884e-07,2
France,FRA,Summer,2020,39055282.93,67571107.0,0.5779879102765032,10,12,11,33,30,24,11,65,1.6643074924460674e-06,9.619496096164296e-07,33
United Kingdom,GBR,Summer,2020,40318557.57,67081000.0,0.601042882038133,22,20,22,64,66,40,22,128,3.1747167486775743e-06,1.9081409042799005e-06,64
Georgia,GEO,Summer,2020,4255742.993,3722716.0,1.143182287609369,2,5,1,8,6,10,1,17,3.994602124226537e-06,4.566558394462538e-06,8
Ghana,GHA,Summer,2020,2176579.4590000003,32180401.0,0.0676368035003665,0,0,1,1,0,0,1,1,4.594364776645629e-07,3.1074814760698604e-08,1
"Hong Kong SAR, China",HKG,Summer,2020,46107765.28,7481000.0,6.163315770618901,1,2,3,6,3,4,3,10,2.168832069668244e-07,1.336719689881032e-06,6
Hungary,HUN,Summer,2020,16120989.05,9750149.0,1.6534095068701002,6,7,7,20,18,14,7,39,2.4192064071900104e-06,3.999938872729022e-06,20
India,IND,Summer,2020,1910421.473,1396387127.0,0.0013681173623423,1,2,4,7,3,4,4,11,5.7578917298947255e-06,7.877471646156188e-09,7
Ireland,IRL,Summer,2020,85420190.86,4985382.0,17.13413151890868,2,0,2,4,6,0,2,8,9.365467250139553e-08,1.6046914759992314e-06,4
Israel,ISR,Summer,2020,44846791.6,9215100.0,4.866663584768477,2,0,2,4,6,0,2,8,1.7838511328422437e-07,8.681403348851342e-07,4
Italy,ITA,Summer,2020,31911035.790000003,59438851.0,0.536871679938766,10,10,20,40,30,20,20,70,2.193598492404185e-06,1.1776809077281792e-06,40
Jamaica,JAM,Summer,2020,4897265.897,2820436.0,1.7363506553596677,4,1,4,9,12,2,4,18,3.675520255297259e-06,6.381992004073129e-06,9
Jordan,JOR,Summer,2020,4042769.35,10928721.0,0.3699215443417395,0,1,1,2,0,2,1,3,7.420655843252596e-07,2.7450604695645535e-07,2
Japan,JPN,Summer,2020,39918167.56,126261000.0,0.316155959163954,27,14,17,58,81,28,17,126,3.156457515506255e-06,9.979328533751514e-07,58
Kazakhstan,KAZ,Summer,2020,9121637.138,18755666.0,0.4863403484579007,0,0,8,8,0,0,8,8,8.770355451515002e-07,4.2653777263894556e-07,8
Kenya,KEN,Summer,2020,1936424.589,51985780.0,0.0372491206056733,4,4,2,10,12,8,2,22,1.1361144722584392e-05,4.23192649990055e-07,10
Kyrgyz Republic,KGZ,Summer,2020,1182521.7,6579900.0,0.1797172753385309,0,2,1,3,0,4,1,5,4.228252217274321e-06,7.598899679326434e-07,3
"Korea, Rep.",KOR,Summer,2020,31721298.91,51836239.0,0.6119521694079696,6,4,10,20,18,8,10,36,1.1348841704792598e-06,6.944948301515471e-07,20
Lithuania,LTU,Summer,2020,20339521.27,2794885.0,7.277409006095063,0,1,0,1,0,2,0,2,9.833073126209329e-08,7.155929492626709e-07,1
Morocco,MAR,Summer,2020,3258121.338,36688772.0,0.0888043169719608,1,0,0,1,3,0,0,3,9.207760205276922e-07,8.176888558712187e-08,1
Moldova,MDA,Summer,2020,4500624.464000001,2635130.0,1.7079326120532956,0,0,1,1,0,0,1,1,2.221913887725781e-07,3.794879190020986e-07,1
Mexico,MEX,Summer,2020,8655000.682,125998302.0,0.0686914073016634,0,0,4,4,0,0,4,4,4.621605643912762e-07,3.1746459567367824e-08,4
North Macedonia,MKD,Summer,2020,5965450.232,2072531.0,2.8783406530469264,0,1,0,1,0,2,0,2,3.352638815544141e-07,9.650036597763795e-07,1
Namibia,NAM,Summer,2020,4251172.766,2489098.0,1.7079169908135396,0,1,0,1,0,2,0,2,4.7045841467455444e-07,8.035039198938732e-07,1
Norway,NOR,Summer,2020,67329677.79,5379475.0,12.516031358078624,4,2,2,8,12,4,2,18,2.67341246695724e-07,3.3460514269515147e-06,8
New Zealand,NZL,Summer,2020,41596505.5,5090200.0,8.17188037798122,7,6,7,20,21,12,7,40,9.61619239866195e-07,7.858237397351773e-06,20
Poland,POL,Summer,2020,15816989.4,37899070.0,0.4173450535857476,4,5,5,14,12,10,5,27,1.7070252319951609e-06,7.124185369192436e-07,14
Qatar,QAT,Summer,2020,52315660.08,2760385.0,18.952305595052863,2,0,1,3,6,0,1,7,1.338031478393993e-07,2.535878147432333e-06,3
Romania,ROU,Summer,2020,13047432.06,19265250.0,0.6772521540078639,1,3,0,4,3,6,0,9,6.897909074071087e-07,4.671623778565033e-07,4
San Marino,SMR,Summer,2020,45320208.72,34007.0,1332.67294145323,0,1,2,3,0,2,2,4,8.82608468269208e-08,0.0001176228423559,3
Serbia,SRB,Summer,2020,7733802.869,6899126.0,1.1209829866855598,3,1,5,9,9,2,5,16,2.068839905932182e-06,2.3191343367261304e-06,9
Slovak Republic,SVK,Summer,2020,19545742.82,5458827.0,3.580575610840937,1,2,1,4,3,4,1,8,4.0929628889898606e-07,1.4655163096394152e-06,4
Sweden,SWE,Summer,2020,52837903.98,10353442.0,5.103414302219494,3,6,0,9,9,12,0,21,3.974419577269537e-07,2.028310971365851e-06,9
Syrian Arab Republic,SYR,Summer,2020,533385.2317,20772595.0,0.0256773519004245,0,0,1,1,0,0,1,1,1.8748175625575724e-06,4.8140350302887056e-08,1
Thailand,THA,Summer,2020,6990935.503,71475664.0,0.0978086122152009,1,0,1,2,3,0,1,4,5.721694898034021e-07,5.596310374955033e-08,2
Tunisia,TUN,Summer,2020,3497681.41,12161723.0,0.2875975229825576,1,1,0,2,3,2,0,5,1.4295184191747184e-06,4.111259564125906e-07,2
Turkiye,TUR,Summer,2020,8561070.948,84135428.0,0.1017534604804054,2,2,9,13,6,4,9,19,2.219348503873653e-06,2.258263902811548e-07,13
Uganda,UGA,Summer,2020,846767.2013,44404611.0,0.0190693529845357,2,1,1,4,6,2,1,9,1.0628659194856324e-05,2.02681653939047e-07,4
Ukraine,UKR,Summer,2020,3751740.723,44132049.0,0.0850117048270294,1,6,12,19,3,12,12,27,7.196659362539857e-06,6.118002814689161e-07,19
United States,USA,Summer,2020,63530633.48,331501080.0,0.1916453288176316,39,41,33,113,117,82,33,232,3.651781625521421e-06,6.998468903932379e-07,113
Uzbekistan,UZB,Summer,2020,1749655.8150000002,34232050.0,0.0511116282840203,3,0,2,5,9,0,2,11,6.286950785232008e-06,3.213362915747085e-07,5
