Country_Name,Country_Code,Year,GDP,Gold,Silver,Bronze,Total_Medals,Season
Argentina,ARG,1960,,0,1,1,2,Summer
Australia,AUS,1960,1810.510249,8,8,6,22,Summer
Austria,AUT,1960,935.4604269,1,1,0,2,Summer
Belgium,BEL,1960,1273.691659,0,2,2,4,Summer
Brazil,BRA,1960,232.9987625,0,0,2,2,Summer
Canada,CAN,1960,2259.250511,0,1,0,1,Summer
Spain,ESP,1960,396.3922533,0,0,1,1,Summer
Ethiopia,ETH,1960,,1,0,0,1,Summer
Finland,FIN,1960,1179.353011,1,1,3,5,Summer
France,FRA,1960,1333.881573,0,2,3,5,Summer
United Kingdom,GBR,1960,1397.594803,2,6,12,20,Summer
Ghana,GHA,1960,176.0956484,0,1,0,1,Summer
Hungary,HUN,1960,,6,8,7,21,Summer
India,IND,1960,83.03510182,0,1,0,1,Summer
Iraq,IRQ,1960,237.7132079,0,0,1,1,Summer
Italy,ITA,1960,804.4926233,13,10,13,36,Summer
Japan,JPN,1960,475.3190756,4,7,7,18,Summer
Morocco,MAR,1960,172.5989838,0,1,0,1,Summer
Mexico,MEX,1960,359.5450597,0,0,1,1,Summer
Norway,NOR,1960,1441.75566,1,0,0,1,Summer
New Zealand,NZL,1960,2312.949992,2,0,1,3,Summer
Pakistan,PAK,1960,81.5869473,1,0,1,2,Summer
Poland,POL,1960,,4,6,11,21,Summer
Romania,ROU,1960,,3,1,6,10,Summer
Singapore,SGP,1960,428.05898,0,1,0,1,Summer
Sweden,SWE,1960,2114.002973,1,2,3,6,Summer
Turkiye,TUR,1960,508.2906132,7,2,0,9,Summer
United States,USA,1960,3007.123445,34,21,16,71,Summer
"Venezuela, RB",VEN,1960,953.6779442,0,0,1,1,Summer
Argentina,ARG,1964,1179.504098,0,1,0,1,Summer
Australia,AUS,1964,2131.277657,6,2,10,18,Summer
Belgium,BEL,1964,1701.846276,2,0,1,3,Summer
Brazil,BRA,1964,254.838581,0,0,1,1,Summer
Canada,CAN,1964,2555.111146,1,2,1,4,Summer
Cuba,CUB,1964,,0,1,0,1,Summer
Ethiopia,ETH,1964,,1,0,0,1,Summer
Finland,FIN,1964,1707.503938,3,0,2,5,Summer
France,FRA,1964,1928.999402,1,8,6,15,Summer
United Kingdom,GBR,1964,1748.288118,4,12,2,18,Summer
Ghana,GHA,1964,226.576967,0,0,1,1,Summer
Hungary,HUN,1964,,10,7,5,22,Summer
India,IND,1964,115.4876084,1,0,0,1,Summer
Ireland,IRL,1964,965.1354227,0,0,1,1,Summer
Italy,ITA,1964,1222.54454,10,10,7,27,Summer
Japan,JPN,1964,843.6168785,16,5,8,29,Summer
Kenya,KEN,1964,110.3920208,0,0,1,1,Summer
"Korea, Rep.",KOR,1964,123.6068369,0,2,1,3,Summer
Mexico,MEX,1964,485.80005,0,0,1,1,Summer
New Zealand,NZL,1964,2813.546976,3,0,2,5,Summer
Pakistan,PAK,1964,102.9612072,0,1,0,1,Summer
Poland,POL,1964,,7,6,10,23,Summer
Romania,ROU,1964,,2,4,6,12,Summer
Sweden,SWE,1964,2941.048899,2,2,4,8,Summer
Trinidad and Tobago,TTO,1964,779.3892566,0,1,2,3,Summer
Tunisia,TUN,1964,,0,1,1,2,Summer
Turkiye,TUR,1964,365.1338692,2,3,1,6,Summer
United States,USA,1964,3573.941185,36,26,28,90,Summer
Argentina,ARG,1968,1143.810428,0,0,2,2,Summer
Australia,AUS,1968,2723.999484,5,7,5,17,Summer
Austria,AUT,1968,1677.673528,0,2,2,4,Summer
Belgium,BEL,1968,2222.361511,0,1,1,2,Summer
Brazil,BRA,1968,370.1804118,0,1,2,3,Summer
Canada,CAN,1968,3462.678872,1,3,1,5,Summer
Cameroon,CMR,1968,170.7455914,0,1,0,1,Summer
Cuba,CUB,1968,,0,4,0,4,Summer
Ethiopia,ETH,1968,,1,1,0,2,Summer
Finland,FIN,1968,1907.077272,1,2,1,4,Summer
France,FRA,1968,2553.975843,7,3,5,15,Summer
United Kingdom,GBR,1968,1951.758596,5,5,3,13,Summer
Hungary,HUN,1968,,10,10,12,32,Summer
India,IND,1968,99.51683612,0,0,1,1,Summer
Italy,ITA,1968,1651.939377,3,4,9,16,Summer
Jamaica,JAM,1968,598.1006359,0,1,0,1,Summer
Japan,JPN,1968,1451.337703,11,7,7,25,Summer
Kenya,KEN,1968,127.5024628,3,4,2,9,Summer
"Korea, Rep.",KOR,1968,198.431298,0,1,1,2,Summer
Mexico,MEX,1968,622.4250634,3,3,3,9,Summer
Norway,NOR,1968,2662.117492,1,1,0,2,Summer
New Zealand,NZL,1968,1885.156152,1,0,2,3,Summer
Pakistan,PAK,1968,143.2879463,1,0,0,1,Summer
Poland,POL,1968,,5,2,11,18,Summer
Romania,ROU,1968,,4,6,5,15,Summer
Sweden,SWE,1968,3926.409001,2,1,1,4,Summer
Tunisia,TUN,1968,253.848674,1,0,1,2,Summer
Turkiye,TUR,1968,516.4668063,2,0,0,2,Summer
Uganda,UGA,1968,107.0313041,0,1,1,2,Summer
United States,USA,1968,4695.92339,45,28,34,107,Summer
"Venezuela, RB",VEN,1968,940.2014199,1,0,0,1,Summer
Argentina,ARG,1972,1411.176664,0,1,0,1,Summer
Australia,AUS,1972,3949.461643,8,7,2,17,Summer
Austria,AUT,1972,2924.048879,0,1,2,3,Summer
Belgium,BEL,1972,3831.6319,0,2,0,2,Summer
Brazil,BRA,1972,577.4515372,0,0,2,2,Summer
Canada,CAN,1972,5089.587902,0,2,3,5,Summer
Colombia,COL,1972,395.9876223,0,1,2,3,Summer
Cuba,CUB,1972,887.2171977,3,1,4,8,Summer
Spain,ESP,1972,1708.808629,0,0,1,1,Summer
Ethiopia,ETH,1972,,0,0,2,2,Summer
Finland,FIN,1972,3177.645701,3,1,4,8,Summer
France,FRA,1972,3865.9254,2,4,7,13,Summer
United Kingdom,GBR,1972,3030.432514,4,5,9,18,Summer
Ghana,GHA,1972,225.5289099,0,0,1,1,Summer
Hungary,HUN,1972,,6,13,16,35,Summer
India,IND,1972,122.6124534,0,0,1,1,Summer
Italy,ITA,1972,2671.137314,5,3,10,18,Summer
Jamaica,JAM,1972,978.9849313,0,0,1,1,Summer
Japan,JPN,1972,2967.041996,13,8,8,29,Summer
Kenya,KEN,1972,171.0050917,2,3,4,9,Summer
"Korea, Rep.",KOR,1972,324.1962768,0,1,0,1,Summer
Lebanon,LBN,1972,,0,1,0,1,Summer
Mexico,MEX,1972,844.1744381,0,1,0,1,Summer
Norway,NOR,1972,4413.575692,2,1,1,4,Summer
New Zealand,NZL,1972,3294.648943,1,1,1,3,Summer
Pakistan,PAK,1972,150.6172113,0,1,0,1,Summer
Poland,POL,1972,,7,5,9,21,Summer
"Korea, Dem. People's Rep.",PRK,1972,,1,1,3,5,Summer
Romania,ROU,1972,,3,6,7,16,Summer
Sweden,SWE,1972,6027.128499,4,6,6,16,Summer
Tunisia,TUN,1972,420.5665745,0,1,0,1,Summer
Turkiye,TUR,1972,547.4651976,0,1,0,1,Summer
Uganda,UGA,1972,137.0252176,1,1,0,2,Summer
United States,USA,1972,6094.01799,33,31,30,94,Summer
Australia,AUS,1976,7487.078975,0,1,4,5,Summer
Austria,AUT,1976,5678.386658,0,0,1,1,Summer
Belgium,BEL,1976,7243.047341,0,3,3,6,Summer
Brazil,BRA,1976,1376.347928,0,0,2,2,Summer
Canada,CAN,1976,8809.26466,0,5,6,11,Summer
Cuba,CUB,1976,1436.285607,6,4,3,13,Summer
Spain,ESP,1976,3279.312671,0,2,0,2,Summer
Finland,FIN,1976,6739.690713,4,2,0,6,Summer
France,FRA,1976,6899.069578,2,3,4,9,Summer
United Kingdom,GBR,1976,4138.167788,3,5,5,13,Summer
Hungary,HUN,1976,,4,5,13,22,Summer
Italy,ITA,1976,4033.099354,2,7,4,13,Summer
Jamaica,JAM,1976,1461.458827,1,1,0,2,Summer
Japan,JPN,1976,5197.622337,9,6,10,25,Summer
"Korea, Rep.",KOR,1976,834.134208,1,1,4,6,Summer
Mexico,MEX,1976,1472.658876,1,0,1,2,Summer
Norway,NOR,1976,8927.201627,1,1,0,2,Summer
New Zealand,NZL,1976,4373.840998,2,1,1,4,Summer
Pakistan,PAK,1976,187.4969066,0,0,1,1,Summer
Poland,POL,1976,,7,6,13,26,Summer
"Korea, Dem. People's Rep.",PRK,1976,,1,1,0,2,Summer
Romania,ROU,1976,,4,9,14,27,Summer
Sweden,SWE,1976,10868.27577,4,1,0,5,Summer
Thailand,THA,1976,405.5479499,0,0,1,1,Summer
Trinidad and Tobago,TTO,1976,2341.875013,1,0,0,1,Summer
United States,USA,1976,8592.253537,34,35,25,94,Summer
"Venezuela, RB",VEN,1976,2316.030922,0,1,0,1,Summer
Australia,AUS,1980,10208.57617,2,2,5,9,Summer
Austria,AUT,1980,10869.54649,1,2,1,4,Summer
Belgium,BEL,1980,12864.00257,1,0,0,1,Summer
Brazil,BRA,1980,1941.259538,2,0,2,4,Summer
Cuba,CUB,1980,2030.041049,8,7,5,20,Summer
Spain,ESP,1980,6208.578019,1,3,2,6,Summer
Ethiopia,ETH,1980,,2,0,2,4,Summer
Finland,FIN,1980,11223.93756,3,1,4,8,Summer
France,FRA,1980,12738.52005,6,5,3,14,Summer
United Kingdom,GBR,1980,10032.06208,5,7,9,21,Summer
Guyana,GUY,1980,775.1459824,0,0,1,1,Summer
Hungary,HUN,1980,,7,10,15,32,Summer
India,IND,1980,267.3905787,1,0,0,1,Summer
Ireland,IRL,1980,6372.437775,0,1,1,2,Summer
Italy,ITA,1980,8456.918974,8,3,4,15,Summer
Jamaica,JAM,1980,1254.671851,0,0,3,3,Summer
Lebanon,LBN,1980,,0,0,1,1,Summer
Mexico,MEX,1980,3029.887355,0,1,3,4,Summer
Poland,POL,1980,,3,14,15,32,Summer
"Korea, Dem. People's Rep.",PRK,1980,,0,3,2,5,Summer
Romania,ROU,1980,,6,6,13,25,Summer
Sweden,SWE,1980,17097.83265,3,3,6,12,Summer
Uganda,UGA,1980,93.69222855,0,1,0,1,Summer
"Venezuela, RB",VEN,1980,3886.573956,0,1,0,1,Summer
Australia,AUS,1984,12421.4926,4,8,12,24,Summer
Austria,AUT,1984,8991.06504,1,1,1,3,Summer
Belgium,BEL,1984,8457.268803,1,1,2,4,Summer
Brazil,BRA,1984,1406.6898,1,5,2,8,Summer
Canada,CAN,1984,13877.91708,10,18,16,44,Summer
China,CHN,1984,250.713969,15,8,9,32,Summer
Cote d'Ivoire,CIV,1984,711.0852016,0,1,0,1,Summer
Cameroon,CMR,1984,768.9839227,0,0,1,1,Summer
Colombia,COL,1984,1333.370911,0,1,0,1,Summer
Dominican Republic,DOM,1984,1845.560023,0,0,1,1,Summer
"Egypt, Arab Rep.",EGY,1984,697.8979337,0,1,0,1,Summer
Spain,ESP,1984,4489.988939,1,2,2,5,Summer
Finland,FIN,1984,10833.86629,4,2,6,12,Summer
France,FRA,1984,9430.069648,5,7,16,28,Summer
United Kingdom,GBR,1984,8179.194441,5,11,21,37,Summer
Ireland,IRL,1984,5692.027386,0,1,0,1,Summer
Iceland,ISL,1984,11959.54001,0,0,1,1,Summer
Italy,ITA,1984,7739.715284,14,6,12,32,Summer
Jamaica,JAM,1984,1048.351309,0,1,2,3,Summer
Japan,JPN,1984,10978.91981,10,8,14,32,Summer
Kenya,KEN,1984,330.1540534,1,0,2,3,Summer
"Korea, Rep.",KOR,1984,2413.263925,6,6,7,19,Summer
Morocco,MAR,1984,675.0192871,2,0,0,2,Summer
Mexico,MEX,1984,2507.312061,2,3,1,6,Summer
Norway,NOR,1984,14989.48577,0,1,2,3,Summer
New Zealand,NZL,1984,6713.760131,8,1,2,11,Summer
Pakistan,PAK,1984,331.3887658,1,0,0,1,Summer
Peru,PER,1984,911.7892245,0,1,0,1,Summer
Romania,ROU,1984,,20,16,17,53,Summer
Sweden,SWE,1984,13099.02083,2,11,6,19,Summer
Syrian Arab Republic,SYR,1984,1885.019531,0,1,0,1,Summer
Thailand,THA,1984,842.0699352,0,1,0,1,Summer
Turkiye,TUR,1984,1247.016105,0,0,3,3,Summer
United States,USA,1984,17121.22548,83,61,30,174,Summer
"Venezuela, RB",VEN,1984,3539.754463,0,0,3,3,Summer
Argentina,ARG,1988,3982.444402,0,1,1,2,Summer
Australia,AUS,1988,14284.51581,3,6,5,14,Summer
Austria,AUT,1988,17578.61894,1,0,0,1,Summer
Belgium,BEL,1988,16391.09383,0,0,2,2,Summer
Brazil,BRA,1988,1781.817876,1,2,3,6,Summer
Canada,CAN,1988,18936.9641,3,2,5,10,Summer
Channel Islands,CHI,1988,,0,1,0,1,Summer
China,CHN,1988,283.5376952,5,11,12,28,Summer
Colombia,COL,1988,1254.531546,0,0,1,1,Summer
Djibouti,DJI,1988,820.5767723,0,0,1,1,Summer
Spain,ESP,1988,9703.123838,1,1,2,4,Summer
Finland,FIN,1988,22047.79332,1,1,2,4,Summer
France,FRA,1988,17727.51083,6,4,6,16,Summer
United Kingdom,GBR,1988,15987.16808,5,10,9,24,Summer
Hungary,HUN,1988,,11,6,6,23,Summer
Italy,ITA,1988,15744.66126,6,4,4,14,Summer
Jamaica,JAM,1988,1625.74427,0,2,0,2,Summer
Japan,JPN,1988,25059.00743,4,3,7,14,Summer
Kenya,KEN,1988,386.3559486,5,2,2,9,Summer
"Korea, Rep.",KOR,1988,4748.629608,12,10,11,33,Summer
Morocco,MAR,1988,1076.092773,1,0,2,3,Summer
Mexico,MEX,1988,2302.027017,0,0,2,2,Summer
Norway,NOR,1988,24207.28147,2,3,0,5,Summer
New Zealand,NZL,1988,13759.15563,3,2,8,13,Summer
Pakistan,PAK,1988,356.3352154,0,0,1,1,Summer
Peru,PER,1988,730.2097626,0,1,0,1,Summer
Poland,POL,1988,,2,5,9,16,Summer
Romania,ROU,1988,1769.889931,7,11,6,24,Summer
Senegal,SEN,1988,902.2699219,0,1,0,1,Summer
Suriname,SUR,1988,2887.061439,1,0,0,1,Summer
Sweden,SWE,1988,24534.69382,0,4,7,11,Summer
Thailand,THA,1988,1154.579398,0,0,1,1,Summer
Turkiye,TUR,1988,1737.94868,1,1,0,2,Summer
United States,USA,1988,21417.01193,36,31,27,94,Summer
Argentina,ARG,1992,6815.61829,0,0,1,1,Summer
Australia,AUS,1992,18624.55508,7,9,11,27,Summer
Austria,AUT,1992,24880.16412,0,2,0,2,Summer
Belgium,BEL,1992,23372.61917,0,1,2,3,Summer
Brazil,BRA,1992,2105.107748,2,1,0,3,Summer
Canada,CAN,1992,20879.84833,7,4,7,18,Summer
China,CHN,1992,366.4606923,16,22,16,54,Summer
Colombia,COL,1992,1721.29168,0,0,1,1,Summer
Cuba,CUB,1992,2048.068839,14,6,11,31,Summer
Spain,ESP,1992,16112.18892,13,7,2,22,Summer
Estonia,EST,1992,,1,0,1,2,Summer
Ethiopia,ETH,1992,201.7435026,1,0,2,3,Summer
Finland,FIN,1992,22319.05946,1,2,2,5,Summer
France,FRA,1992,23814.22737,8,5,16,29,Summer
United Kingdom,GBR,1992,20487.17079,5,3,12,20,Summer
Ghana,GHA,1992,394.9070373,0,0,1,1,Summer
Hungary,HUN,1992,3735.10582,11,12,7,30,Summer
Ireland,IRL,1992,15714.38475,1,1,0,2,Summer
Israel,ISR,1992,,0,1,1,2,Summer
Italy,ITA,1992,23243.47453,6,5,8,19,Summer
Jamaica,JAM,1992,1452.188387,0,3,1,4,Summer
Japan,JPN,1992,31414.98464,3,8,11,22,Summer
Kenya,KEN,1992,332.9502514,2,4,2,8,Summer
"Korea, Rep.",KOR,1992,8126.67039,12,5,12,29,Summer
Lithuania,LTU,1992,,1,0,1,2,Summer
Morocco,MAR,1992,1317.329956,1,1,1,3,Summer
Mexico,MEX,1992,4272.785965,0,1,0,1,Summer
Namibia,NAM,1992,2346.287909,0,2,0,2,Summer
Norway,NOR,1992,30523.98506,2,4,1,7,Summer
New Zealand,NZL,1992,11793.13924,1,4,5,10,Summer
Pakistan,PAK,1992,399.4650488,0,0,1,1,Summer
Peru,PER,1992,1560.546504,0,1,0,1,Summer
Poland,POL,1992,2459.020685,3,6,10,19,Summer
"Korea, Dem. People's Rep.",PRK,1992,,4,0,5,9,Summer
Qatar,QAT,1992,16223.78008,0,0,1,1,Summer
Romania,ROU,1992,1102.103785,4,6,8,18,Summer
Suriname,SUR,1992,964.4332465,0,0,1,1,Summer
Sweden,SWE,1992,32800.98269,1,7,4,12,Summer
Thailand,THA,1992,1957.407581,0,0,1,1,Summer
Turkiye,TUR,1992,2814.447556,2,2,2,6,Summer
United States,USA,1992,25418.99078,37,34,37,108,Summer
Argentina,ARG,1996,7690.157003,0,2,1,3,Summer
Armenia,ARM,1996,484.091641,1,1,0,2,Summer
Australia,AUS,1996,22020.09372,9,9,23,41,Summer
Austria,AUT,1996,29809.07677,0,1,2,3,Summer
Azerbaijan,AZE,1996,409.1631891,0,1,0,1,Summer
Burundi,BDI,1996,146.5361825,1,0,0,1,Summer
Belgium,BEL,1996,27489.55518,2,2,2,6,Summer
Belarus,BLR,1996,1452.507105,1,6,8,15,Summer
Brazil,BRA,1996,5121.905407,3,3,9,15,Summer
Canada,CAN,1996,21227.34753,3,11,8,22,Summer
China,CHN,1996,709.4137551,16,22,12,50,Summer
Cuba,CUB,1996,2281.97555,9,8,8,25,Summer
Czechia,CZE,1996,6532.837055,4,3,4,11,Summer
Ecuador,ECU,1996,2142.328641,1,0,0,1,Summer
Spain,ESP,1996,16109.0844,5,6,6,17,Summer
Ethiopia,ETH,1996,144.0316487,2,0,1,3,Summer
Finland,FIN,1996,25783.45049,1,2,1,4,Summer
France,FRA,1996,26870.28524,15,7,15,37,Summer
United Kingdom,GBR,1996,24440.32814,1,8,6,15,Summer
Georgia,GEO,1996,689.0594414,0,0,2,2,Summer
"Hong Kong SAR, China",HKG,1996,24818.15455,1,0,0,1,Summer
Hungary,HUN,1996,4525.039103,7,4,10,21,Summer
India,IND,1996,399.5775035,0,0,1,1,Summer
Ireland,IRL,1996,20835.89771,3,0,1,4,Summer
Israel,ISR,1996,20116.98187,0,0,1,1,Summer
Italy,ITA,1996,23081.60468,13,10,12,35,Summer
Jamaica,JAM,1996,2919.144486,1,3,2,6,Summer
Japan,JPN,1996,39150.03963,3,6,5,14,Summer
Kazakhstan,KAZ,1996,1350.30567,3,4,4,11,Summer
Kenya,KEN,1996,436.1954516,1,4,3,8,Summer
"Korea, Rep.",KOR,1996,13403.04959,7,15,5,27,Summer
Lithuania,LTU,1996,2327.434857,0,0,1,1,Summer
Morocco,MAR,1996,1585.718384,0,0,2,2,Summer
Moldova,MDA,1996,575.1454551,0,1,1,2,Summer
Mexico,MEX,1996,4487.291779,0,0,1,1,Summer
Mozambique,MOZ,1996,239.8574043,0,0,1,1,Summer
Namibia,NAM,1996,2417.605515,0,2,0,2,Summer
Norway,NOR,1996,37321.9742,2,2,3,7,Summer
New Zealand,NZL,1996,18794.43604,3,2,1,6,Summer
Poland,POL,1996,4147.465501,7,5,5,17,Summer
"Korea, Dem. People's Rep.",PRK,1996,,2,1,2,5,Summer
Romania,ROU,1996,1633.010644,4,7,9,20,Summer
Russian Federation,RUS,1996,2643.929199,26,21,16,63,Summer
Slovak Republic,SVK,1996,5196.94038,1,1,1,3,Summer
Sweden,SWE,1996,32998.96816,2,4,2,8,Summer
Syrian Arab Republic,SYR,1996,4184.29444,1,0,0,1,Summer
Thailand,THA,1996,3039.8901,1,0,1,2,Summer
Trinidad and Tobago,TTO,1996,4385.0987,0,0,2,2,Summer
Tunisia,TUN,1996,2077.007469,0,0,1,1,Summer
Turkiye,TUR,1996,3009.855034,4,1,1,6,Summer
Uganda,UGA,1996,284.4568035,0,0,1,1,Summer
Ukraine,UKR,1996,872.6987305,9,2,12,23,Summer
United States,USA,1996,29967.71272,44,32,25,101,Summer
Uzbekistan,UZB,1996,600.5981578,0,1,1,2,Summer
Argentina,ARG,2000,7666.517834,0,2,2,4,Summer
Armenia,ARM,2000,603.2980252,0,0,1,1,Summer
Australia,AUS,2000,21853.78167,16,25,17,58,Summer
Austria,AUT,2000,24625.60072,2,1,0,3,Summer
Azerbaijan,AZE,2000,655.1199452,2,0,1,3,Summer
Belgium,BEL,2000,23098.88651,0,2,3,5,Summer
Belarus,BLR,2000,1276.288034,3,3,11,17,Summer
Brazil,BRA,2000,3726.81142,0,6,6,12,Summer
Canada,CAN,2000,24271.00206,3,3,8,14,Summer
Channel Islands,CHI,2000,44316.15359,0,0,1,1,Summer
China,CHN,2000,959.3724836,28,16,14,58,Summer
Cameroon,CMR,2000,700.1632136,1,0,0,1,Summer
Colombia,COL,2000,2547.143528,1,0,0,1,Summer
Cuba,CUB,2000,2752.203783,11,11,7,29,Summer
Czechia,CZE,2000,6029.038193,2,3,3,8,Summer
Spain,ESP,2000,14749.68742,3,3,5,11,Summer
Estonia,EST,2000,4070.609024,1,0,2,3,Summer
Ethiopia,ETH,2000,122.9622935,4,1,3,8,Summer
Finland,FIN,2000,24345.91482,2,1,1,4,Summer
France,FRA,2000,22416.42542,13,14,11,38,Summer
United Kingdom,GBR,2000,28290.9725,11,10,7,28,Summer
Georgia,GEO,2000,749.908535,0,0,6,6,Summer
Hungary,HUN,2000,4624.281657,8,6,3,17,Summer
India,IND,2000,442.0347789,0,0,1,1,Summer
Ireland,IRL,2000,26334.56721,0,1,0,1,Summer
Iceland,ISL,2000,32096.37226,0,0,1,1,Summer
Israel,ISR,2000,21630.74761,0,0,1,1,Summer
Italy,ITA,2000,20137.59122,13,8,13,34,Summer
Jamaica,JAM,2000,3447.303896,0,6,3,9,Summer
Japan,JPN,2000,39169.35957,5,8,5,18,Summer
Kazakhstan,KAZ,2000,1229.001247,3,4,0,7,Summer
Kenya,KEN,2000,411.8215792,2,3,2,7,Summer
Kyrgyz Republic,KGZ,2000,279.6195693,0,0,1,1,Summer
"Korea, Rep.",KOR,2000,12256.99357,8,10,10,28,Summer
Lithuania,LTU,2000,3293.229979,2,0,3,5,Summer
Morocco,MAR,2000,1348.049805,0,1,4,5,Summer
Moldova,MDA,2000,440.538684,0,1,1,2,Summer
Mexico,MEX,2000,7232.878809,1,2,3,6,Summer
North Macedonia,MKD,2000,1861.898065,0,0,1,1,Summer
Mozambique,MOZ,2000,318.3426885,1,0,0,1,Summer
Norway,NOR,2000,38131.46061,4,3,3,10,Summer
New Zealand,NZL,2000,13641.10272,1,0,3,4,Summer
Poland,POL,2000,4501.454067,6,5,3,14,Summer
"Korea, Dem. People's Rep.",PRK,2000,,0,1,3,4,Summer
Qatar,QAT,2000,27494.77133,0,0,1,1,Summer
Romania,ROU,2000,1659.90764,11,6,9,26,Summer
Russian Federation,RUS,2000,1771.594116,32,28,29,89,Summer
Slovak Republic,SVK,2000,5426.624281,1,3,1,5,Summer
Sweden,SWE,2000,29624.91267,4,5,3,12,Summer
Thailand,THA,2000,2004.107209,1,0,2,3,Summer
Trinidad and Tobago,TTO,2000,6120.942704,0,1,1,2,Summer
Turkiye,TUR,2000,4278.39313,3,0,2,5,Summer
Ukraine,UKR,2000,658.3486328,3,10,10,23,Summer
United States,USA,2000,36329.95607,37,24,32,93,Summer
Uzbekistan,UZB,2000,558.2268024,1,1,2,4,Summer
Argentina,ARG,2004,4258.160261,2,0,4,6,Summer
Australia,AUS,2004,30819.99349,17,16,17,50,Summer
Austria,AUT,2004,36889.23351,2,4,1,7,Summer
Azerbaijan,AZE,2004,1045.009379,1,0,4,5,Summer
Belgium,BEL,2004,35429.40779,1,0,2,3,Summer
Belarus,BLR,2004,2378.623286,2,5,6,13,Summer
Brazil,BRA,2004,3623.247996,5,2,3,10,Summer
Canada,CAN,2004,32143.68141,3,6,3,12,Summer
Channel Islands,CHI,2004,57202.56103,2,0,1,3,Summer
China,CHN,2004,1508.668098,32,17,14,63,Summer
Cameroon,CMR,2004,1119.98093,1,0,0,1,Summer
Colombia,COL,2004,2811.197871,0,0,2,2,Summer
Cuba,CUB,2004,3403.296163,9,7,11,27,Summer
Czechia,CZE,2004,11749.85266,1,3,5,9,Summer
Dominican Republic,DOM,2004,2468.437673,1,0,0,1,Summer
"Egypt, Arab Rep.",EGY,2004,1016.253884,1,1,3,5,Summer
Eritrea,ERI,2004,401.3745252,0,0,1,1,Summer
Spain,ESP,2004,24907.00085,3,11,6,20,Summer
Estonia,EST,2004,8914.103557,0,1,2,3,Summer
Ethiopia,ETH,2004,134.5424863,2,3,2,7,Summer
Finland,FIN,2004,37772.17811,0,2,0,2,Summer
France,FRA,2004,33797.16244,11,9,13,33,Summer
United Kingdom,GBR,2004,40390.78583,9,9,12,30,Summer
Georgia,GEO,2004,1305.047486,2,2,0,4,Summer
"Hong Kong SAR, China",HKG,2004,24928.10037,0,1,0,1,Summer
Hungary,HUN,2004,10301.70339,8,6,3,17,Summer
India,IND,2004,624.1050944,0,1,0,1,Summer
Israel,ISR,2004,20557.07863,1,0,1,2,Summer
Italy,ITA,2004,31317.20079,10,11,11,32,Summer
Jamaica,JAM,2004,3819.284231,2,1,2,5,Summer
Japan,JPN,2004,38298.98017,16,9,12,37,Summer
Kazakhstan,KAZ,2004,2874.288483,1,4,3,8,Summer
Kenya,KEN,2004,462.6182158,1,4,2,7,Summer
"Korea, Rep.",KOR,2004,16496.12009,9,12,9,30,Summer
Lithuania,LTU,2004,6700.327192,1,2,0,3,Summer
Morocco,MAR,2004,1964.080078,2,1,0,3,Summer
Mexico,MEX,2004,7525.465234,0,3,1,4,Summer
Norway,NOR,2004,57603.83602,5,0,1,6,Summer
New Zealand,NZL,2004,25420.23488,3,2,0,5,Summer
Poland,POL,2004,6681.386472,3,2,5,10,Summer
"Korea, Dem. People's Rep.",PRK,2004,,0,4,1,5,Summer
Romania,ROU,2004,3494.944517,8,5,6,19,Summer
Russian Federation,RUS,2004,4102.364746,28,26,36,90,Summer
Slovak Republic,SVK,2004,10691.44655,2,2,2,6,Summer
Sweden,SWE,2004,42821.67314,4,2,1,7,Summer
Syrian Arab Republic,SYR,2004,6241.058232,0,0,1,1,Summer
Thailand,THA,2004,2647.26172,3,1,4,8,Summer
Trinidad and Tobago,TTO,2004,9756.500371,0,0,1,1,Summer
Turkiye,TUR,2004,6031.947927,3,3,4,10,Summer
Ukraine,UKR,2004,1416.60376,8,5,9,22,Summer
United States,USA,2004,41724.63163,36,39,26,101,Summer
Uzbekistan,UZB,2004,465.1198869,2,1,2,5,Summer
"Venezuela, RB",VEN,2004,4287.707147,0,0,2,2,Summer
Afghanistan,AFG,2008,387.8491743,0,0,1,1,Summer
Argentina,ARG,2008,8977.506851,2,0,4,6,Summer
Armenia,ARM,2008,3908.94906,0,1,4,5,Summer
Australia,AUS,2008,49679.18053,14,15,17,46,Summer
Austria,AUT,2008,51919.98358,0,1,2,3,Summer
Azerbaijan,AZE,2008,5574.603802,1,1,4,6,Summer
Belgium,BEL,2008,48303.39796,2,0,0,2,Summer
Belarus,BLR,2008,6377.369732,3,4,7,14,Summer
Brazil,BRA,2008,8801.599484,3,4,10,17,Summer
Canada,CAN,2008,46710.50558,3,9,8,20,Summer
Channel Islands,CHI,2008,,0,1,0,1,Summer
China,CHN,2008,3468.304602,48,22,30,100,Summer
Cameroon,CMR,2008,1476.009215,1,0,0,1,Summer
Colombia,COL,2008,5527.449953,0,2,1,3,Summer
Cuba,CUB,2008,4992.824494,3,10,17,30,Summer
Czechia,CZE,2008,22804.57768,3,3,1,7,Summer
Dominican Republic,DOM,2008,5053.324577,1,1,0,2,Summer
Ecuador,ECU,2008,4260.433184,0,1,0,1,Summer
"Egypt, Arab Rep.",EGY,2008,1941.899973,0,0,2,2,Summer
Spain,ESP,2008,35510.72223,5,11,3,19,Summer
Estonia,EST,2008,18204.96648,1,1,0,2,Summer
Ethiopia,ETH,2008,320.8610897,4,2,1,7,Summer
Finland,FIN,2008,53772.79424,1,1,2,4,Summer
France,FRA,2008,45515.96175,7,16,20,43,Summer
United Kingdom,GBR,2008,47429.93634,19,13,19,51,Summer
Georgia,GEO,2008,3324.735879,3,2,2,7,Summer
Hungary,HUN,2008,15772.33008,3,5,2,10,Summer
India,IND,2008,993.5037725,1,0,2,3,Summer
Ireland,IRL,2008,61353.10656,0,1,2,3,Summer
Iceland,ISL,2008,56943.37045,0,1,0,1,Summer
Israel,ISR,2008,30173.36159,0,0,1,1,Summer
Italy,ITA,2008,40944.91242,8,9,10,27,Summer
Jamaica,JAM,2008,5056.258245,5,4,2,11,Summer
Japan,JPN,2008,39876.30397,9,8,8,25,Summer
Kazakhstan,KAZ,2008,8458.017154,2,3,4,9,Summer
Kenya,KEN,2008,915.9989157,6,4,6,16,Summer
Kyrgyz Republic,KGZ,2008,966.3936272,0,1,2,3,Summer
"Korea, Rep.",KOR,2008,21350.42798,13,11,8,32,Summer
Lithuania,LTU,2008,14944.99665,0,3,2,5,Summer
Morocco,MAR,2008,2889.220947,0,1,1,2,Summer
Moldova,MDA,2008,2110.56199,0,0,1,1,Summer
Mexico,MEX,2008,10119.83621,2,0,2,4,Summer
Norway,NOR,2008,96944.09561,3,5,1,9,Summer
New Zealand,NZL,2008,31252.96256,3,2,4,9,Summer
Panama,PAN,2008,7197.110786,1,0,0,1,Summer
Poland,POL,2008,13996.02515,4,5,2,11,Summer
"Korea, Dem. People's Rep.",PRK,2008,,2,2,2,6,Summer
Romania,ROU,2008,10435.04398,4,1,4,9,Summer
Russian Federation,RUS,2008,11635.27246,24,13,23,60,Summer
Singapore,SGP,2008,40007.46926,0,1,0,1,Summer
Serbia,SRB,2008,7101.040141,0,1,2,3,Summer
Slovak Republic,SVK,2008,18753.58494,3,3,0,6,Summer
Sweden,SWE,2008,56152.55234,0,4,1,5,Summer
Thailand,THA,2008,4327.7976,2,2,2,6,Summer
Tajikistan,TJK,2008,704.6553137,0,1,1,2,Summer
Trinidad and Tobago,TTO,2008,20011.14827,1,1,0,2,Summer
Tunisia,TUN,2008,4200.31582,1,0,0,1,Summer
Turkiye,TUR,2008,10802.78061,1,1,3,5,Summer
Ukraine,UKR,2008,4066.547852,7,4,11,22,Summer
United States,USA,2008,48570.04598,36,39,37,112,Summer
Uzbekistan,UZB,2008,1082.286025,0,1,3,4,Summer
"Venezuela, RB",VEN,2008,11310.77817,0,0,1,1,Summer
Afghanistan,AFG,2012,663.1410528,0,0,1,1,Summer
Argentina,ARG,2012,13082.66433,1,1,2,4,Summer
Armenia,ARM,2012,3643.715183,0,1,1,2,Summer
Australia,AUS,2012,68044.71482,8,15,12,35,Summer
Azerbaijan,AZE,2012,7496.294648,2,2,5,9,Summer
Belgium,BEL,2012,44670.56068,0,1,2,3,Summer
Belarus,BLR,2012,6953.132515,2,5,3,10,Summer
Brazil,BRA,2012,12327.31744,3,5,9,17,Summer
Brunei Darussalam,BRN,2012,46842.96026,1,0,0,1,Summer
Canada,CAN,2012,52669.08996,2,6,10,18,Summer
China,CHN,2012,6300.615118,38,31,22,91,Summer
Cameroon,CMR,2012,1433.724035,0,0,1,1,Summer
Colombia,COL,2012,8101.829092,1,3,5,9,Summer
Cuba,CUB,2012,6467.337914,5,3,7,15,Summer
Cyprus,CYP,2012,28993.34961,0,1,0,1,Summer
Czechia,CZE,2012,19870.80121,4,3,4,11,Summer
Dominican Republic,DOM,2012,6049.471741,1,1,0,2,Summer
"Egypt, Arab Rep.",EGY,2012,3059.135428,0,3,1,4,Summer
Spain,ESP,2012,28322.94659,4,10,6,20,Summer
Estonia,EST,2012,17403.20533,0,1,1,2,Summer
Ethiopia,ETH,2012,458.5509208,3,2,3,8,Summer
Finland,FIN,2012,47708.06128,0,2,1,3,Summer
France,FRA,2012,40870.85236,11,11,13,35,Summer
Gabon,GAB,2012,9348.515572,0,1,0,1,Summer
United Kingdom,GBR,2012,42485.58607,29,18,18,65,Summer
Georgia,GEO,2012,4421.818242,1,2,3,6,Summer
"Hong Kong SAR, China",HKG,2012,36730.8767,0,0,1,1,Summer
Hungary,HUN,2012,12984.83657,8,4,6,18,Summer
India,IND,2012,1434.018198,0,2,4,6,Summer
Ireland,IRL,2012,49054.69743,1,1,4,6,Summer
Italy,ITA,2012,35051.52127,8,9,11,28,Summer
Jamaica,JAM,2012,5365.242293,4,5,3,12,Summer
Japan,JPN,2012,49145.28043,7,14,17,38,Summer
Kazakhstan,KAZ,2012,12386.69927,3,1,7,11,Summer
Kenya,KEN,2012,1289.780822,2,4,7,13,Summer
"Korea, Rep.",KOR,2012,25466.76052,13,9,8,30,Summer
Lithuania,LTU,2012,14367.70942,2,0,3,5,Summer
Morocco,MAR,2012,2907.449219,0,0,1,1,Summer
Mexico,MEX,2012,10376.05767,1,3,4,8,Summer
Montenegro,MNE,2012,6586.721279,0,1,0,1,Summer
Norway,NOR,2012,101524.1419,2,1,1,4,Summer
New Zealand,NZL,2012,39973.38076,6,2,5,13,Summer
Poland,POL,2012,13010.92339,3,2,6,11,Summer
"Korea, Dem. People's Rep.",PRK,2012,,4,0,3,7,Summer
Qatar,QAT,2012,98041.36224,0,1,1,2,Summer
Romania,ROU,2012,8930.729912,2,4,1,7,Summer
Russian Federation,RUS,2012,15420.875,19,21,26,66,Summer
Singapore,SGP,2012,55546.48854,0,0,2,2,Summer
Serbia,SRB,2012,6015.945228,1,1,2,4,Summer
Slovak Republic,SVK,2012,17498.3539,0,1,3,4,Summer
Sweden,SWE,2012,58037.82132,1,4,3,8,Summer
Thailand,THA,2012,5748.631241,0,2,2,4,Summer
Tajikistan,TJK,2012,959.361905,0,0,1,1,Summer
Trinidad and Tobago,TTO,2012,18961.23359,1,1,2,4,Summer
Tunisia,TUN,2012,4233.894568,2,0,1,3,Summer
Turkiye,TUR,2012,11697.48051,1,1,1,3,Summer
Uganda,UGA,2012,796.711135,1,0,0,1,Summer
Ukraine,UKR,2012,4004.804443,5,4,10,19,Summer
United States,USA,2012,51784.41857,47,27,30,104,Summer
Uzbekistan,UZB,2012,2267.623275,0,0,3,3,Summer
"Venezuela, RB",VEN,2012,12937.9276,1,0,0,1,Summer
Argentina,ARG,2016,12790.24247,3,1,0,4,Summer
Armenia,ARM,2016,3679.951972,1,3,0,4,Summer
Australia,AUS,2016,49875.56514,8,11,10,29,Summer
Austria,AUT,2016,45307.58786,0,0,1,1,Summer
Azerbaijan,AZE,2016,3880.738731,1,7,10,18,Summer
Burundi,BDI,2016,242.0656705,0,1,0,1,Summer
Belgium,BEL,2016,42012.62272,2,2,2,6,Summer
Belarus,BLR,2016,5039.681886,1,4,4,9,Summer
Brazil,BRA,2016,8680.768792,7,6,6,19,Summer
Brunei Darussalam,BRN,2016,26762.94565,1,1,0,2,Summer
Canada,CAN,2016,42315.60371,4,3,15,22,Summer
China,CHN,2016,8094.363367,26,18,26,70,Summer
Cote d'Ivoire,CIV,2016,1980.878142,1,0,1,2,Summer
Colombia,COL,2016,5938.463856,3,2,3,8,Summer
Cuba,CUB,2016,8055.889907,5,2,4,11,Summer
Czechia,CZE,2016,18575.23203,1,2,7,10,Summer
Dominican Republic,DOM,2016,7191.076572,0,0,1,1,Summer
"Egypt, Arab Rep.",EGY,2016,3331.612461,0,0,3,3,Summer
Spain,ESP,2016,26537.15949,7,4,6,17,Summer
Estonia,EST,2016,18295.34293,0,0,1,1,Summer
Ethiopia,ETH,2016,705.616305,1,2,5,8,Summer
Finland,FIN,2016,43814.02651,0,0,1,1,Summer
France,FRA,2016,37062.53357,10,18,14,42,Summer
United Kingdom,GBR,2016,41146.07736,27,23,17,67,Summer
Georgia,GEO,2016,4062.169888,2,1,4,7,Summer
Hungary,HUN,2016,13104.69955,8,3,4,15,Summer
India,IND,2016,1714.280355,0,1,1,2,Summer
Ireland,IRL,2016,62895.91112,0,2,0,2,Summer
Israel,ISR,2016,37690.47395,0,0,2,2,Summer
Italy,ITA,2016,30960.73151,8,12,8,28,Summer
Jamaica,JAM,2016,5022.704717,6,3,2,11,Summer
Jordan,JOR,2016,4003.404749,1,0,0,1,Summer
Japan,JPN,2016,39375.47316,12,8,21,41,Summer
Kazakhstan,KAZ,2016,7714.841844,2,5,10,17,Summer
Kenya,KEN,2016,1562.076142,6,6,1,13,Summer
"Korea, Rep.",KOR,2016,29288.87044,9,3,9,21,Summer
Lithuania,LTU,2016,15008.31324,0,1,3,4,Summer
Morocco,MAR,2016,3132.94458,0,0,1,1,Summer
Mexico,MEX,2016,8875.062256,0,3,2,5,Summer
Norway,NOR,2016,70460.56053,0,0,4,4,Summer
New Zealand,NZL,2016,40058.19616,4,9,5,18,Summer
Poland,POL,2016,12378.75944,2,3,6,11,Summer
"Korea, Dem. People's Rep.",PRK,2016,,2,3,2,7,Summer
Qatar,QAT,2016,58467.23557,0,1,0,1,Summer
Romania,ROU,2016,9404.341874,1,1,2,4,Summer
Russian Federation,RUS,2016,8704.898438,19,17,20,56,Summer
Singapore,SGP,2016,56860.41324,1,0,0,1,Summer
Serbia,SRB,2016,5765.200762,2,4,2,8,Summer
Slovak Republic,SVK,2016,16563.4405,2,2,0,4,Summer
Sweden,SWE,2016,51965.15715,2,6,3,11,Summer
Thailand,THA,2016,5854.461088,2,2,2,6,Summer
Tajikistan,TJK,2016,801.3912831,1,0,0,1,Summer
Trinidad and Tobago,TTO,2016,15991.10879,0,0,1,1,Summer
Tunisia,TUN,2016,3796.16792,0,0,3,3,Summer
Turkiye,TUR,2016,10734.37997,1,3,4,8,Summer
Ukraine,UKR,2016,2187.730469,2,5,4,11,Summer
United States,USA,2016,57866.74493,46,37,38,121,Summer
Uzbekistan,UZB,2016,2704.677188,4,2,7,13,Summer
"Venezuela, RB",VEN,2016,,0,2,1,3,Summer
Argentina,ARG,2020,8496.424142,0,1,2,3,Summer
Armenia,ARM,2020,4505.867364,0,2,2,4,Summer
Australia,AUS,2020,51720.37076,17,7,22,46,Summer
Austria,AUT,2020,48809.22688,1,1,5,7,Summer
Azerbaijan,AZE,2020,4229.910649,0,3,4,7,Summer
Belgium,BEL,2020,45517.79493,3,1,3,7,Summer
Belarus,BLR,2020,6542.797491,1,3,3,7,Summer
Brazil,BRA,2020,6794.489159,7,6,8,21,Summer
Brunei Darussalam,BRN,2020,27179.41199,0,1,0,1,Summer
Canada,CAN,2020,43258.26387,7,6,11,24,Summer
China,CHN,2020,10408.66976,38,32,18,88,Summer
Cote d'Ivoire,CIV,2020,2288.119498,0,0,1,1,Summer
Colombia,COL,2020,5307.215228,0,4,1,5,Summer
Cuba,CUB,2020,9499.590202,7,3,5,15,Summer
Czechia,CZE,2020,22992.87938,4,4,3,11,Summer
Dominican Republic,DOM,2020,7167.919159,0,3,2,5,Summer
Ecuador,ECU,2020,5645.19929,2,1,0,3,Summer
"Egypt, Arab Rep.",EGY,2020,3398.801432,1,1,4,6,Summer
Spain,ESP,2020,26959.67544,3,8,6,17,Summer
Estonia,EST,2020,23595.24368,1,0,1,2,Summer
Ethiopia,ETH,2020,918.6525941,1,1,2,4,Summer
Finland,FIN,2020,49170.75215,0,0,2,2,Summer
France,FRA,2020,39055.28293,10,12,11,33,Summer
United Kingdom,GBR,2020,40318.55757,22,20,22,64,Summer
Georgia,GEO,2020,4255.742993,2,5,1,8,Summer
Ghana,GHA,2020,2176.579459,0,0,1,1,Summer
"Hong Kong SAR, China",HKG,2020,46107.76528,1,2,3,6,Summer
Hungary,HUN,2020,16120.98905,6,7,7,20,Summer
India,IND,2020,1910.421473,1,2,4,7,Summer
Ireland,IRL,2020,85420.19086,2,0,2,4,Summer
Israel,ISR,2020,44846.7916,2,0,2,4,Summer
Italy,ITA,2020,31911.03579,10,10,20,40,Summer
Jamaica,JAM,2020,4897.265897,4,1,4,9,Summer
Jordan,JOR,2020,4042.76935,0,1,1,2,Summer
Japan,JPN,2020,39918.16756,27,14,17,58,Summer
Kazakhstan,KAZ,2020,9121.637138,0,0,8,8,Summer
Kenya,KEN,2020,1936.424589,4,4,2,10,Summer
Kyrgyz Republic,KGZ,2020,1182.5217,0,2,1,3,Summer
"Korea, Rep.",KOR,2020,31721.29891,6,4,10,20,Summer
Lithuania,LTU,2020,20339.52127,0,1,0,1,Summer
Morocco,MAR,2020,3258.121338,1,0,0,1,Summer
Moldova,MDA,2020,4500.624464,0,0,1,1,Summer
Mexico,MEX,2020,8655.000682,0,0,4,4,Summer
North Macedonia,MKD,2020,5965.450232,0,1,0,1,Summer
Namibia,NAM,2020,4251.172766,0,1,0,1,Summer
Norway,NOR,2020,67329.67779,4,2,2,8,Summer
New Zealand,NZL,2020,41596.5055,7,6,7,20,Summer
Poland,POL,2020,15816.9894,4,5,5,14,Summer
Qatar,QAT,2020,52315.66008,2,0,1,3,Summer
Romania,ROU,2020,13047.43206,1,3,0,4,Summer
San Marino,SMR,2020,45320.20872,0,1,2,3,Summer
Serbia,SRB,2020,7733.802869,3,1,5,9,Summer
Slovak Republic,SVK,2020,19545.74282,1,2,1,4,Summer
Sweden,SWE,2020,52837.90398,3,6,0,9,Summer
Syrian Arab Republic,SYR,2020,533.3852317,0,0,1,1,Summer
Thailand,THA,2020,6990.935503,1,0,1,2,Summer
Turkmenistan,TKM,2020,,0,1,0,1,Summer
Tunisia,TUN,2020,3497.68141,1,1,0,2,Summer
Turkiye,TUR,2020,8561.070948,2,2,9,13,Summer
Uganda,UGA,2020,846.7672013,2,1,1,4,Summer
Ukraine,UKR,2020,3751.740723,1,6,12,19,Summer
United States,USA,2020,63530.63348,39,41,33,113,Summer
Uzbekistan,UZB,2020,1749.655815,3,0,2,5,Summer
"Venezuela, RB",VEN,2020,,1,3,0,4,Summer
